Section Title,Market Dynamics - a,Intra-Industry Competition - a,Technology Risk - a,Regulatory Framework - a,Total
RISK FACTORS,318,133,385,977,1813
MANAGEMENT’S DISCUSSION AND ANALYSIS OF FINANCIAL CONDITION AND RESULTS OF OPERATIONS,171,7,219,141,538
SUMMARY,41,1,229,80,351
PLAN OF DISTRIBUTION,0,24,0,274,298
DESCRIPTION OF THE NOTES,0,0,5,284,289
INDUSTRY,34,0,129,58,221
BUSINESS,15,0,62,41,118
DESCRIPTION OF OTHER INDEBTEDNESS,3,0,1,86,90
CERTAIN ERISA CONSIDERATIONS,0,0,0,87,87
REGULATION,3,1,5,72,81
LIMITATIONS ON VALIDITY AND ENFORCEABILITY OF THE GUARANTEES AND CERTAIN INSOLVENCY LAW CONSIDERATIONS,0,0,1,76,77
DESCRIPTION OF CERTAIN FINANCING ARRANGEMENTS,0,0,0,74,74
CAPITALIZATION,2,0,16,52,70
INDUSTRY AND MARKET DATA,11,4,22,24,61
DESCRIPTION OF NOTES,0,0,1,54,55
CERTAIN LIMITATIONS ON THE VALIDITY AND THE ENFORCEABILITY OF THE GUARANTEES AND THE SECURITY INTERESTS AND CERTAIN INSOLVENCY LAW CONSIDERATIONS,1,0,1,52,54
TRANSFER RESTRICTIONS,0,1,0,52,53
OUR BUSINESS,2,0,25,22,49
LIMITATIONS ON VALIDITY AND ENFORCEABILITY OF THE GUARANTEES AND THE SECURITY INTERESTS AND CERTAIN INSOLVENCY LAW CONSIDERATIONS,0,0,0,47,47
WHERE YOU CAN FIND MORE INFORMATION,6,2,11,27,46
CERTAIN TAX CONSIDERATIONS,0,0,0,45,45
IMPORTANT NOTICE,0,0,0,44,44
FORWARD-LOOKING STATEMENTS,13,0,12,18,43
STABILIZATION,0,6,0,36,42
LIMITATIONS ON VALIDITY AND ENFORCEABILITY OF THE SECURITY AND THE GUARANTEES AND CERTAIN INSOLVENCY LAW CONSIDERATIONS,0,0,1,41,42
REGULATORY ENVIRONMENT,3,1,11,26,41
STABLE UTILIZATION RATES OF DACH PARTICLEBOARD** **INDUSTRY EBITDA MARGINS FOLLOWING CAPACITY REDUCTIONS** **SIGNIGICANTLY INCREASED,8,0,14,19,41
REGULATORY MATTERS,0,1,2,34,37
WHERE PROSPECTIVE INVESTORS CAN FIND MORE INFORMATION,3,0,3,31,37
CERTAIN U.S. FEDERAL INCOME TAX CONSIDERATIONS,0,0,0,36,36
TAXATION,0,0,0,35,35
LITIGATION,0,2,1,32,35
IMPORTANT INFORMATION ABOUT THIS OFFERING MEMORANDUM,0,1,0,33,34
MANAGEMENT’S DISCUSSION AND ANALYSIS OF FINANCIAL CONDITION AND RESULTS OF OPERATIONS OF SIGURA,8,0,17,7,32
DESCRIPTION OF CERTAIN OTHER INDEBTEDNESS,0,0,1,29,30
INDEPENDENT AUDITORS,2,2,3,21,28
CERTAIN UNITED STATES FEDERAL INCOME TAX CONSIDERATIONS,0,0,0,28,28
3.** **CAPITAL MANAGEMENT,5,0,8,15,28
CERTAIN INSOLVENCY LAW CONSIDERATIONS AND LIMITATIONS ON THE VALIDITY AND ENFORCEABILITY OF THE GUARANTEES AND THE SECURITY INTERESTS,0,2,0,25,27
CERTAIN INSOLVENCY LAW CONSIDERATIONS AND LIMITATIONS ON THE VALIDITY AND ENFORCEABILITY OF THE SUBSIDIARY GUARANTEES AND SECURITY INTERESTS,1,0,1,25,27
"MORE FLEXIBILITY, TIME SAVING,AND A PERCEIVED FASTER CAREER PATH ARE KEY ATTRACTION POINTS FOR ONLINE",0,0,15,12,27
THE OFFERING,4,0,3,19,26
SUMMARY HISTORICAL FINANCIAL INFORMATION AND OTHER DATA,0,1,9,16,26
COVID-19,2,0,17,6,25
NOTICE TO INVESTORS,0,3,0,21,24
SUBSCRIPTION AND SALE,0,0,0,24,24
LTIP 2019,2,1,6,15,24
LIMITATIONS ON VALIDITY AND ENFORCEABILITY OF THE GUARANTEES,0,0,0,24,24
OFFERING CIRCULAR SUMMARY,2,0,18,4,24
BOOK ENTRY; DELIVERY AND FORM,0,0,3,19,22
LTIP 2020,2,1,4,15,22
DESCRIPTION OF THE SENIOR SECURED NOTES,0,0,0,22,22
LIMITATIONS ON VALIDITY AND ENFORCEABILITY OF THE SECURITY AND THE GUARANTEES,0,0,0,22,22
OUR STRENGTHS,8,1,11,1,21
CERTAIN ITALIAN TAX CONSIDERATIONS,0,0,0,21,21
LIMITATIONS ON VALIDITY AND ENFORCEABILITY OF ANY NOTES GUARANTEES AND THE COLLATERAL AND CERTAIN INSOLVENCY LAW CONSIDERATIONS,0,0,0,21,21
"BOOK ENTRY, DELIVERY AND FORM",0,0,6,14,20
(IN MILLIONS),2,0,4,14,20
I-LOGIC TECHNOLOGIES BIDCO LIMITED COMPANY INFORMATION,3,0,6,10,19
IMPORTANT INFORMATION FOR INVESTORS,0,2,0,16,18
KEY INCOME STATEMENT ITEMS,17,0,0,1,18
CERTAIN INSOLVENCY CONSIDERATIONS AND LIMITATIONS ON THE VALIDITY AND ENFORCEABILITY OF THE NOTES GUARANTEES AND THE SECURITY INTERESTS,0,0,0,18,18
LIABILITIES AND STOCKHOLDERS’ EQUITY,6,1,2,8,17
KEY FACTORS AFFECTING OUR RESULTS OF OPERATIONS,9,0,2,6,17
CASH FLOWS FROM FINANCING ACTIVITIES:,4,0,4,9,17
IMPORTANT INFORMATION,0,1,0,15,16
SERVICE OF PROCESS AND ENFORCEMENT OF JUDGMENTS,1,1,0,14,16
LIABILITIES AND EQUITY,4,0,3,9,16
CERTAIN INSOLVENCY LAW CONSIDERATIONS AND LIMITATIONS ON THE VALIDITY AND ENFORCEABILITY OF THE SENIOR SECURED NOTES GUARANTEES AND SECURITY INTERESTS,0,1,0,15,16
LIMITATIONS ON VALIDITY AND ENFORCEABILITY OF THE NOTES COLLATERAL AND ANY FUTURE NOTES GUARANTEES AND CERTAIN INSOLVENCY LAW CONSIDERATIONS,0,0,0,16,16
NOTES TO CONSOLIDATED FINANCIAL STATEMENTS 1.** **BASIS OF PRESENTATION,1,0,5,9,15
DESCRIPTION OF CERTAIN FINANCING AND GUARANTEE ARRANGEMENTS,0,0,1,14,15
UNITED KINGDOM,0,0,0,15,15
PRINCIPAL STOCKHOLDERS,0,0,0,15,15
ACURIS INTERNATIONAL LIMITED COMPANY INFORMATION,0,1,6,8,15
PRESENTATION OF INDUSTRY AND MARKET DATA,5,3,6,0,14
DESCRIPTION OF SECURED NOTES,0,0,0,14,14
LEGAL MATTERS,1,0,1,11,13
INDEX TO THE FINANCIAL STATEMENTS,5,0,5,3,13
NOTES TO CONDENSED CONSOLIDATED FINANCIAL STATEMENTS 1.** **BASIS OF PRESENTATION,1,1,5,6,13
INDUSTRY AND MARKET OVERVIEW,2,0,7,4,13
KEY MARKET DEVELOPMENTS,8,2,3,0,13
CONSOLIDATED STATEMENTS OF COMPREHENSIVE INCOME,5,0,1,7,13
INDEPENDENT ACCOUNTANTS,1,0,0,11,12
CERTAIN RELATIONSHIPS AND RELATED PARTY TRANSACTIONS,0,0,1,11,12
REPORT OF INDEPENDENT REGISTERED PUBLIC ACCOUNTING FIRM,3,0,2,7,12
CERTAIN INSOLVENCY LAW CONSIDERATIONS AND LIMITATIONS ON THE VALIDITY AND ENFORCEABILITY OF THE GUARANTEES,0,0,0,12,12
TELECOMMUNICATION REGULATORY FRAMEWORK IN BRAZIL,0,0,3,9,12
DESCRIPTION OF UNSECURED NOTES,0,0,0,12,12
POLAND,0,0,0,12,12
CERTAIN INSOLVENCY LAW CONSIDERATIONS,0,0,0,12,12
"STABILIZATION IN** **CONNECTION** **WITH** **THIS** **OFFERING,** **CREDIT** **SUISSE** **SECURITIES** **(EUROPE) LIMITED (THE “STABILIZATION MANAGER”) (OR PERSON(S) ACTING ON BEHALF OF THE STABILIZATION MANAGER), MAY OVER-ALLOT NOTES OR EFFECT TRANSACTIONS WITH A",0,0,0,12,12
U.S. FEDERAL INCOME TAX CONSIDERATIONS,0,0,0,11,11
TABLE OF CONTENTS,0,0,0,11,11
CONSTANTIN ASSOCIES,4,0,1,6,11
WHERE YOU CAN FIND ADDITIONAL INFORMATION,1,0,6,4,11
DESCRIPTION OF TIM,3,0,5,3,11
WACC,2,1,2,6,11
"ONLINE UNIVERSITIES ARE CONSIDERED AS SIMILAR, IF NOT BETTER, THAN TRADITIONAL ONES FOR QUALITY OF TEACHING",0,0,7,4,11
INFORMATION REGARDING FORWARD-LOOKING STATEMENTS,3,0,3,4,10
MANAGEMENT'S DISCUSSION AND ANALYSIS OF FINANCIAL CONDITION AND RESULTS OF OPERATIONS,7,0,2,1,10
CERTAIN LIMITATIONS ON VALIDITY AND ENFORCEABILITY OF THE NOTE GUARANTEES AND THE COLLATERAL AND CERTAIN INSOLVENCY LAW CONSIDERATIONS,0,0,0,10,10
INDUSTRY FUNDAMENTALS AND DRIVERS,6,0,4,0,10
F.** **DISCLOSURES AND EXPLANATIONS ON INDIVIDUAL LINE ITEMS IN THE CONSOLIDATED BALANCE SHEET AND CONSOLIDATED INCOME STATEMENT,1,0,0,9,10
UNDERWRITING,0,1,0,9,10
IN THE UNITED STATES,1,0,1,8,10
"TOTAL NON-CURRENT LIABILITIES . . . . . . . . . . . . . . . . . . . . . . . . . . . . . . . .** **138,7",6,0,1,2,9
AVAILABLE INFORMATION,0,0,1,8,9
CAUTIONARY STATEMENT REGARDING FORWARD-LOOKING STATEMENTS,3,0,3,3,9
DESCRIPTION OF EURO NOTES,0,0,1,8,9
NOTICE TO U.S. INVESTORS,0,0,0,9,9
CAUTIONARY NOTE REGARDING FORWARD-LOOKING STATEMENTS,2,1,3,3,9
INDUSTRY OVERVIEW,2,1,3,3,9
CERTAIN UNITED STATES FEDERAL INCOME TAX CONSEQUENCES,0,0,0,9,9
MANAGEMENT’S DISCUSSION AND ANALYSIS OF FINANCIAL CONDITION AND RESULTS OF OPERATIONS OF THE COMBINED COMPANY,4,0,3,2,9
"THE NOTES MAY NOT BE OFFERED TO THE PUBLIC IN ANY JURISDICTION. BY ACCEPTING DELIVERY OF THIS OFFERING MEMORANDUM, YOU AGREE NOT TO OFFER, SELL, RESELL, TRANSFER OR DELIVER, DIRECTLY OR INDIRECTLY, ANY NOTES TO THE PUBLIC. NOTICE TO CANADIAN INVESTORS",0,0,0,9,9
MANAGEMENT’S DISCUSSION AND ANALYSIS OF FINANCIAL CONDITION AND RESULTS OF OPERATIONS OF SOLENIS,4,2,3,0,9
INDEPENDENT REGISTERED PUBLIC ACCOUNTING FIRM,0,0,3,5,8
FATCA,0,0,0,8,8
DELOITTE & ASSOCIES,3,0,0,5,8
DISCLOSURE REGARDING FORWARD-LOOKING STATEMENTS,3,0,1,4,8
THE TRANSACTIONS,0,0,0,8,8
TERMS AND CONDITIONS OF THE NOTES,0,0,0,8,8
DESCRIPTION OF SENIOR SECURED NOTES,0,0,0,8,8
SUSTAINABILITY FOCUS; RESEARCH AND DEVELOPMENT,2,2,2,2,8
MANAGEMENT’S DISCUSSION AND ANALYSIS OF FINANCIAL CONDITION AND RESULTS OF OPERATIONS - ALLIANCE,5,0,1,2,8
ASSETS,0,1,2,5,8
OFFERING MEMORANDUM SUMMARY,5,0,1,2,8
V** **- NOTES TO THE CONSOLIDATED FINANCIAL STATEMENTS,2,0,3,3,8
DESCRIPTION OF DOLLAR NOTES,0,0,0,7,7
NOTES TO COMBINED FINANCIAL STATEMENTS,3,0,0,4,7
MANAGEMENT’S DISCUSSION AND ANALYSIS OF FINANCIAL CONDITION AND RESULTS OF OPERATIONS OF LABL,4,0,1,2,7
MANAGEMENT’S DISCUSSION AND ANALYSIS OF FINANCIAL CONDITION AND RESULTS OF OPERATIONS OF FORT DEARBORN,3,0,2,2,7
INDEPENDENT AUDITORS’ REVIEW REPORT,1,0,2,4,7
CANADIAN RESALE RESTRICTIONS,0,0,0,7,7
CERTAIN INSOLVENCY LAW AND LOCAL LAW LIMITATIONS,0,0,0,7,7
SPECIAL NOTE REGARDING FORWARD-LOOKING STATEMENTS,1,0,2,3,6
MARKET AND INDUSTRY DATA,2,2,1,1,6
COMPLIANCE RISKS,0,0,2,4,6
EXPLANATION OF EFFECT ON VALUE OF INVESTMENT,0,0,3,3,6
END-MARKETS DYNAMICS,4,0,2,0,6
MANAGEMENT’S DISCUSSION AND ANALYSIS OF FINANCIAL CONDITION AND RESULTS OF OPERATIONS - AKUMIN,4,0,1,1,6
CONTENTS,0,0,0,6,6
CERTAIN LIMITATIONS ON THE VALIDITY AND ENFORCEABILITY OF THE NOTES GUARANTEE AND THE COLLATERAL,0,0,0,6,6
"STABILIZATION IN CONNECTION WITH THIS OFFERING, GOLDMAN SACHS BANK EUROPE SE (THE “STABILIZATION MANAGER”) OR ANY PERSONS ACTING ON ITS BEHALF IT MAY OVER- ALLOT NOTES OR EFFECT TRANSACTIONS WITH A VIEW TO SUPPORTING THE MARKET PRICE OF THE NOTES AT A LEVEL HIGHER THAN THAT WHICH MIGHT NOT OTHERWISE",0,0,0,6,6
EBITDA,2,0,1,2,5
OVERVIEW,0,0,2,3,5
NON-GAAP FINANCIAL MEASURES,0,0,0,5,5
NOTICE TO PROSPECTIVE U.S. INVESTORS,0,0,0,5,5
REGULATION 1.** **THE EU REGULATORY FRAMEWORK,0,0,2,3,5
DESCRIPTION OF OTHER INDEBTEDNESS OF VODAFONEZIGGO,0,0,0,5,5
EQUITY AND LIABILITIES,0,0,5,0,5
IMPORTANT INFORMATION YOU MUST READ THE FOLLOWING DISCLAIMER BEFORE CONTINUING. THE FOLLOWING APPLIES TO THIS,0,0,0,5,5
PROVISIONS RELATING TO THE NOTES WHILE REPRESENTED BY THE GLOBAL NOTES,0,0,0,5,5
"TOTAL ASSETS** **341,828",0,1,1,3,5
WHERE YOU CAN FIND ADDITIONAL INFORMATION AND INCORPORATION BY REFERENCE,0,0,2,3,5
DESCRIPTION OF CERTAIN FINANCING ARRANGEMENTS[129],0,0,0,5,5
LIABILITIES AND STOCKHOLDERS’ DEFICIT,1,0,0,4,5
(MSEK)** **2019,1,0,2,2,5
"THE SECURITIES OFFERED HEREBY HAVE NOT BEEN RECOMMENDED BY ANY UNITED STATES FEDERAL OR STATE SECURITIES COMMISSION OR REGULATORY AUTHORITY. FURTHERMORE, THE FOREGOING AUTHORITIES HAVE NOT CONFIRMED THE ACCURACY OR DETERMINED THE ADEQUACY OF THIS DOCUMENT. ANY REPRESENTATION TO THE CONTRARY IS A CRIMINAL OFFENSE. THERE ARE NO REGISTRATION RIGHTS ASSOCIATED WITH THE NOTES OR THE GUARANTEES.",1,0,1,2,4
SUMMARY CONSOLIDATED FINANCIAL AND OTHER INFORMATION,2,0,1,1,4
OUR COMPANY,1,0,3,0,4
SERVICE OF PROCESS AND ENFORCEMENT OF CIVIL LIABILITIES,0,0,0,4,4
CLIMATE** **CIRCULAR** **BUILDING** **SUSTAINABLE SUPPLY ACTION** **SOLUTIONS** **TRUST** **CHAIN,0,1,0,3,4
NOTES TO THE CONSOLIDATED FINANCIAL STATEMENTS,0,0,1,3,4
NOTICE TO CERTAIN EUROPEAN INVESTORS,0,0,0,4,4
"BOOK-ENTRY, DELIVERY AND FORM",0,0,1,3,4
CERTAIN CANADIAN FEDERAL INCOME TAX CONSIDERATIONS,0,0,0,4,4
APPLICABLE FINAL TERMS,0,0,0,4,4
4.** **MERGERS AND SIMILAR EVENTS,0,0,0,4,4
4.** **WHOLESALE MARKETS,0,0,0,4,4
GLOSSARY OF TECHNICAL TERMS,0,0,2,2,4
CAUTIONARY STATEMENT ABOUT FORWARD-LOOKING STATEMENTS,1,0,2,1,4
CERTAIN CONSIDERATIONS FOR BENEFIT PLAN INVESTORS,0,0,0,4,4
BOOK-ENTRY; DELIVERY AND FORM,0,0,0,4,4
MARKET AND COMPETITIVE LANDSCAPE,0,0,2,2,4
BUSINESS OUR COMPANY,2,0,2,0,4
DIFFERENTIATED COMBINATION OF SCALE & PREMIUM POSITIONING,0,1,2,1,4
ENVIRONMENTAL REGULATION,0,0,0,4,4
UNITED STATES FEDERAL INCOME TAX CONSEQUENCES FOR NON-U.S. HOLDERS,0,0,0,4,4
ERISA AND OTHER CONSIDERATIONS,0,0,0,4,4
NOTE 9. SUBSEQUENT EVENTS,0,0,0,4,4
PEGASO[(*)],1,0,3,0,4
U������������,1,0,1,2,4
PAPER,1,0,2,1,4
CERTAIN RELATIONSHIPS AND RELATED PARTY TRANSACTIONS OF VODAFONEZIGGO,0,0,0,4,4
GENERAL DESCRIPTION OF THE SECURITIES WE MAY OFFER,0,1,1,2,4
" YOU SHOULD CONSULT YOUR TAX ADVISOR AS TO THE PARTICULAR TAX CONSEQUENCES TO YOU ARISING FROM YOUR PURCHASE, OWNERSHIP AND DISPOSITION OF A NOTE, INCLUDING THE APPLICABILITY OF ANY U.S. FEDERAL ESTATE OR GIFT TAX LAWS, ANY U.S. STATE, LOCAL OR NON-U.S. TAX LAWS AND ANY PROPOSED CHANGES IN APPLICABLE TAX LAWS. ",0,0,0,4,4
LIABILITIES AND MEMBER’S:,0,0,1,2,3
2.** **SUMMARY OF SIGNIFICANT ACCOUNTING POLICIES,1,0,0,2,3
PRELIMINARY OFFERING MEMORANDUM** **CONFIDENTIAL,0,0,0,3,3
INDEPENDENT AUDITOR’S REPORT,0,0,0,3,3
SUMMARY FINANCIAL AND OTHER DATA,1,0,0,2,3
INCORPORATION BY REFERENCE,0,0,0,3,3
U.S. FEDERAL INCOME TAX CONSEQUENCES,0,0,0,3,3
PRELIMINARY** **OFFERING MEMORANDUM** **STRICTLY CONFIDENTIAL,0,0,0,3,3
BOOK ENTRY DELIVERY AND FORM,0,0,0,3,3
MANAGEMENT,0,0,2,1,3
"PROSPECTIVE PURCHASERS OF THE NOTES ARE ADVISED TO CONSULT THEIR OWN TAX ADVISORS AS TO THE TAX CONSEQUENCES OF THE PURCHASE, OWNERSHIP AND DISPOSAL OF THE NOTES, INCLUDING THE EFFECT OF ANY STATE, LOCAL OR CHURCH TAXES, UNDER THE TAX LAWS OF GERMANY AND ANY COUNTRY OF WHICH THEY ARE RESIDENT OR WHOSE TAX LAWS APPLY TO THEM FOR OTHER REASONS.",0,0,0,3,3
TELECOM ITALIA FINANCE S.A.,0,0,0,3,3
FACTORS WHICH ARE MATERIAL FOR THE PURPOSE OF ASSESSING THE MARKET RISKS ASSOCIATED WITH THE NOTES ISSUED UNDER THE PROGRAMME.,0,0,0,3,3
14.** **NOTICES,0,0,0,3,3
12.** **ANTITRUST ISSUES,0,1,0,2,3
NOTICE TO SWISS INVESTORS,0,0,0,3,3
FINAL TERMS AND DRAWDOWN PROSPECTUSES,0,0,0,3,3
REDEMPTION YEAR** **PRICE,0,0,0,3,3
NOTICE TO EEA INVESTORS,0,0,0,3,3
SIGNIFICANT ACCOUNTING POLICIES,0,0,0,3,3
INTRODUCTION,1,0,2,0,3
MANAGEMENT OVERVIEW,0,0,1,2,3
TAXATION CERTAIN GERMAN TAX CONSIDERATIONS,0,0,0,3,3
D.** **CONSOLIDATION PRINCIPLES,2,0,0,1,3
CAUTION REGARDING FORWARD-LOOKING STATEMENTS,1,0,1,1,3
INFORMATION REGARDING FORWARD–LOOKING STATEMENTS,1,1,1,0,3
REGISTRATION RIGHTS,0,0,1,2,3
CAUTIONARY NOTE REGARDING FORWARD LOOKING STATEMENTS,1,0,1,1,3
LIABILITIES AND INVESTED EQUITY,0,1,0,2,3
FINANCIAL PERFORMANCE,1,0,0,2,3
PRINCIPLES OF ECONOMIC REGULATION,0,0,0,3,3
SENIOR BORROWER GROUP INDEBTEDNESS,0,0,0,3,3
MATERIAL U.S. FEDERAL INCOME TAX CONSIDERATIONS,0,0,0,3,3
THIS OFFERING MEMORANDUM CONTAINS IMPORTANT INFORMATION WHICH YOU SHOULD READ BEFORE YOU MAKE ANY DECISION WITH RESPECT TO AN INVESTMENT IN THE NOTES. FORWARD-LOOKING STATEMENTS,1,0,1,1,3
EXISTING SENIOR SECURED IKB FACILITIES,0,0,0,3,3
EXISTING SENIOR SECURED COMMERZBANK FACILITIES,0,0,0,3,3
BOOK-ENTRY CLEARANCE PROCEDURES,0,0,1,2,3
SELECTED CONSOLIDATED FINANCIAL DATA,2,0,0,0,2
MATERIAL UNITED STATES FEDERAL INCOME TAX CONSIDERATIONS,0,0,0,2,2
4.** **INVENTORIES,1,0,1,0,2
8.** **DEBT,0,1,0,1,2
9.** **PRODUCT WARRANTIES,1,0,0,1,2
SUMMARY HISTORICAL CONSOLIDATED FINANCIAL INFORMATION,0,0,1,1,2
WHERE YOU CAN FIND MORE INFORMATION; INCORPORATION BY REFERENCE,0,0,0,2,2
CERTAIN DEFINITIONS,0,0,0,2,2
BOOK-ENTRY SETTLEMENT AND CLEARANCE,0,0,0,2,2
PRINCIPAL SHAREHOLDERS,1,0,1,0,2
LTIP 2018,0,0,0,2,2
INCOME STATEMENTS,0,0,0,2,2
CURRENCY PRESENTATION AND DEFINED TERMS,0,0,1,1,2
OVERVIEW OF THE PROGRAMME,0,0,0,2,2
3.** **INTERESTS OF NATURAL AND LEGAL PERSONS INVOLVED IN THE ISSUE,0,0,0,2,2
"NONE OF THE U.S. SECURITIES AND EXCHANGE COMMISSION (“SEC”), ANY STATE SECURITIES COMMISSION OR OTHER U.S. REGULATORY AUTHORITY HAS APPROVED OR DISAPPROVED OF THE NOTES OR THE RELATED GUARANTEES NOR HAVE ANY OF THE FOREGOING AUTHORITIES PASSED UPON OR ENDORSED THE MERITS OF THIS OFFERING OR THE ACCURACY OR ADEQUACY OF THIS OFFERING MEMORANDUM. ANY REPRESENTATION TO THE CONTRARY IS A CRIMINAL OFFENSE.",0,1,0,1,2
IMPORTANT NOTICES,0,0,0,2,2
PART B – OTHER INFORMATION,0,0,0,2,2
PROHIBITION OF SALES TO EEA RETAIL INVESTORS,0,0,0,2,2
QUANTITATIVE AND QUALITATIVE DISCLOSURES ABOUT MARKET RISK,0,0,0,2,2
SUMMARY OF SIGNIFICANT DIFFERENCES BETWEEN GERMAN GAAP AND IFRS,0,0,0,2,2
HISTORY,0,0,2,0,2
PRODUCTION FACILITIES AND THE CHP,2,0,0,0,2
INFORMATION TECHNOLOGY AND PROCESS MANAGEMENT,0,0,2,0,2
SUMMARY FINANCIAL AND OPERATING INFORMATION,1,0,0,1,2
THE DISCUSSION ABOVE IS A GENERAL SUMMARY. IT DOES NOT COVER ALL TAX MATTERS THAT MAY BE OF IMPORTANCE TO A PARTICULAR PURCHASER. EACH PROSPECTIVE PURCHASER IS URGED TO CONSULT ITS OWN TAX ADVISOR ABOUT THE TAX CONSEQUENCES TO IT OF AN INVESTMENT IN THE NOTES IN LIGHT OF THE PURCHASER’S OWN CIRCUMSTANCES.,0,0,0,2,2
PRELIMINARY OFFERING CIRCULAR** **CONFIDENTIAL,0,0,0,2,2
"FORT DEARBORN HOLDING COMPANY, INC. AND SUBSIDIARIES",2,0,0,0,2
THE ROLE OF HEATHROW,0,0,1,1,2
"HEATHROW AIRPORT’S INFRASTRUCTURE, FACILITIES AND ACCESS",0,0,1,1,2
TRAFFIC,2,0,0,0,2
7.** **REDEMPTION AND PURCHASE,0,0,0,2,2
EU SAVINGS DIRECTIVE,0,0,0,2,2
NOTE 6. RELATED PARTY TRANSACTIONS,0,0,0,2,2
NOTICE TO TURKISH INVESTORS,0,0,0,2,2
SUMMARY OF THE OFFERING,0,0,0,2,2
"SECURITIES ACT’’), OR THE SECURITIES LAWS OF ANY STATE OF THE UNITED STATES OR",0,0,0,2,2
EXISTING SENIOR SECURED SAARLB FACILITY,0,0,0,2,2
NEW SENIOR SECURED LBBW FACILITIES,0,0,0,2,2
NEW SENIOR SECURED SAARLB FACILITY,0,0,0,2,2
INTERCREDITOR AGREEMENT,0,0,0,2,2
"THE SUMMARY OF U.S. FEDERAL INCOME TAX CONSEQUENCES SET OUT BELOW IS FOR GENERAL INFORMATION ONLY. ALL PROSPECTIVE PURCHASERS SHOULD CONSULT THEIR TAX ADVISORS AS TO THE PARTICULAR TAX CONSEQUENCES TO THEM OF ACQUIRING, OWNING AND DISPOSING OF THE NOTES, INCLUDING THE APPLICABILITY AND EFFECT OF STATE, LOCAL, NON-U.S. AND OTHER TAX LAWS AND POSSIBLE CHANGES IN TAX LAW.",0,0,0,2,2
USE OF PROCEEDS,0,0,0,1,1
8.** **PRODUCT WARRANTIES,1,0,0,0,1
9.** **FAIR VALUE OF FINANCIAL INSTRUMENTS,1,0,0,0,1
10.** **SEGMENTS,1,0,0,0,1
13.** **COMMITMENTS AND CONTINGENCIES,0,0,0,1,1
LIABILITIES AND MEMBER’S EQUITY:,0,0,0,1,1
16.** **SUBSEQUENT EVENTS,0,0,0,1,1
LIABILITIES AND MEMBER’S EQUITY,0,0,0,1,1
13.** **INCOME TAXES,0,0,0,1,1
14.** **SEGMENTS,1,0,0,0,1
LISTING AND GENERAL INFORMATION,0,0,0,1,1
INFORMATION INCORPORATED BY REFERENCE,0,0,0,1,1
SUMMARY CORPORATE AND FINANCING STRUCTURE,0,0,0,1,1
ENFORCEABILITY OF JUDGMENTS,0,0,0,1,1
LEGAL ADVISORS TO THE INITIAL PURCHASERS,0,0,0,1,1
NOTICE TO INVESTORS IN THE EUROPEAN ECONOMIC AREA,0,0,0,1,1
NOTICE TO INVESTORS IN CANADA,0,0,0,1,1
NOTICE TO INVESTORS IN IRELAND,0,0,0,1,1
NOTICE TO INVESTORS IN LUXEMBOURG,0,0,0,1,1
SELECTED HISTORICAL CONSOLIDATED FINANCIAL DATA,0,0,0,1,1
INCORPORATION OF CERTAIN INFORMATION BY REFERENCE,0,0,0,1,1
SUMMARY FINANCIAL AND OTHER INFORMATION,1,0,0,0,1
ALTERNATIVE SETTLEMENT CYCLE,0,0,0,1,1
CURRENCY PRESENTATION AND DEFINITIONS,0,1,0,0,1
NOTICE TO EUROPEAN ECONOMIC AREA INVESTORS,0,0,0,1,1
SUMMARY HISTORICAL CONSOLIDATED FINANCIAL AND OTHER DATA,1,0,0,0,1
STRATEGY,0,0,1,0,1
NOTICE TO INVESTORS; TRANSFER RESTRICTIONS,0,0,0,1,1
SELECTED CONSOLIDATED FINANCIAL INFORMATION,0,0,0,1,1
PRESENTATION OF FINANCIAL INFORMATION,0,0,0,1,1
"RESTRICTION TERMINATION DATE""), WHICH IS: ONE YEAR AFTER THE LATER OF THE",0,0,0,1,1
REPORT ON THE OTHER INFORMATION INCLUDED IN THE ANNUAL REPORT,0,0,0,1,1
CONSOLIDATED CASH FLOW STATEMENT FOR 2021,0,0,0,1,1
LEGAL ADVISORS TO THE ISSUER AND THE GUARANTORS,0,0,0,1,1
THE COMPANY,0,0,1,0,1
NOTICE TO CERTAIN EUROPEAN ECONOMIC AREA INVESTORS,0,0,0,1,1
"FIDUCIARY”), HAS RELIED AS A PRIMARY BASIS IN CONNECTION WITH ITS",0,0,0,1,1
OPERATIONAL RISKS,0,0,0,1,1
PART B – OTHER INFORMATION 1.** **LISTING AND ADMISSION TO TRADING,0,0,0,1,1
3.** **RESTRICTIONS ON SECURITY INTERESTS,0,0,0,1,1
8.** **TAXATION,0,0,0,1,1
3.** **MARKET ANALYSES,0,0,0,1,1
5.** **ACCOUNTING SEPARATION AND COST ACCOUNTING,0,0,0,1,1
8.** **THE UNIVERSAL SERVICE,0,0,0,1,1
9.** **CONTRIBUTION FEES FOR THE FUNCTIONING OF AGCOM,0,0,0,1,1
11.** **PRIVACY AND DATA PROTECTION,0,0,0,1,1
DESCRIPTION OF TI FINANCE,0,0,0,1,1
NOTICE TO UNITED KINGDOM INVESTORS,0,0,0,1,1
SELECTED COMBINED FINANCIAL INFORMATION,1,0,0,0,1
BASE PROSPECTUS,0,0,0,1,1
FORM OF FINAL TERMS,0,0,0,1,1
INFORMATION WE INCORPORATE BY REFERENCE,0,0,0,1,1
ITALIAN “WHITE LIST STATES”,0,0,0,1,1
INCORPORATION BY REFERENCE; WHERE YOU CAN FIND ADDITIONAL INFORMATION,0,0,0,1,1
INCORPORATION OF CERTAIN DOCUMENTS BY REFERENCE,0,0,0,1,1
CERTAIN UNITED STATES FEDERAL INCOME TAX CONSIDERATIONS IN GENERAL,0,0,0,1,1
PROPAPIER,1,0,0,0,1
PROWELL,0,0,1,0,1
INSURANCE,0,0,0,1,1
AMENDED AND RESTATED SUPER SENIOR REVOLVING CREDIT FACILITY,0,0,0,1,1
SENIOR SECURED EUR FACILITY,0,0,0,1,1
AMENDED AND RESTATED INTERCREDITOR AGREEMENT,0,0,0,1,1
EUROPEAN UNION,0,0,0,1,1
"PROGROUP AG OFFENBACH A. D. QUEICH, GERMANY NOTES TO THE CONSOLIDATED FINANCIAL STATEMENTS FOR FINANCIAL YEAR 2015 A.** **GENERAL INFORMATION",0,0,0,1,1
MEANING OF CERTAIN REFERENCES; INFORMATION ABOUT THE ISSUER AND ESCROW ISSUER,0,0,0,1,1
NO REVIEW BY THE SEC OR OTHER SECURITIES REGULATORS,0,0,0,1,1
SUMMARY PRO FORMA AND HISTORICAL CONSOLIDATED FINANCIAL INFORMATION AND OTHER DATA - AKUMIN,1,0,0,0,1
COMPANY OVERVIEW,0,0,1,0,1
KEY STRENGTHS,0,0,0,1,1
MIFID II PRODUCT GOVERNANCE,0,0,0,1,1
REVIEW BY THE SECURITIES AND EXCHANGE COMMISSION,0,0,0,1,1
NOTICE TO CERTAIN INVESTORS IN THE UNITED KINGDOM,0,0,0,1,1
NAME** **AGE*** **POSITION,0,0,0,1,1
THE ACCURACY OR COMPLETENESS OF THE INFORMATION INCLUDED IN THIS OFFERING CIRCULAR AS OF ANY DATE OTHER THAN THE DATE HEREOF.,0,0,0,1,1
RELATIONSHIP BETWEEN THE INITIAL PURCHASERS AND THEIR RESPECTIVE AFFILIATES AND THE COMPANY,0,0,0,1,1
"SECURITIES LAWS OF ANY OTHER JURISDICTION PURSUANT TO REGISTRATION OR EXEMPTION THEREFROM. INVESTORS SHOULD BE AWARE THAT THEY MAY BE REQUIRED TO BEAR THE FINANCIAL RISKS OF THIS INVESTMENT FOR AN INDEFINITE PERIOD OF TIME AND THAT THEIR ABILITY TO TRANSFER INTERESTS IN THESE SECURITIES MAY BE ADVERSELY AFFECTED IF THEY ARE IN POSSESSION OF MATERIAL NON-PUBLIC INFORMATION CONCERNING OUR BUSINESS. PROSPECTIVE INVESTORS MUST COMPLY WITH ALL LAWS APPLICABLE IN ANY JURISDICTION IN WHICH THEY BUY, OFFER OR SELL THE NOTES OR POSSESS OR DISTRIBUTE THIS OFFERING CIRCULAR; NEITHER WE NOR THE INITIAL PURCHASERS SHALL HAVE ANY RESPONSIBILITY FOR ANY OF THE FOREGOING LEGAL REQUIREMENTS. SEE ‘‘TRANSFER RESTRICTIONS’’. LISTING OF THE NOTES",0,0,0,1,1
SUMMARY HISTORICAL FINANCIAL AND OTHER DATA OF THE PARENT GUARANTOR,1,0,0,0,1
WHERE TO FIND ADDITIONAL INFORMATION,0,0,0,1,1
OFFERING MEMORANDUM** **NOT FOR GENERAL DISTRIBUTION STRICTLY CONFIDENTIAL** **IN THE UNITED STATES,0,0,0,1,1
PROHIBITION OF OFFERS TO EEA RETAIL INVESTORS,0,0,0,1,1
PRELIMINARY OFFERING MEMORANDUM** **NOT FOR GENERAL DISTRIBUTION IN THE UNITED STATES,0,0,0,1,1
PROVEN RESILIENCE OF THE RENOVATION END-MARKET,0,0,1,0,1
COMMERCIAL STRATEGY,0,0,1,0,1
THE NOTES,0,0,0,1,1
INDUSTRY SOURCES AND TERMINOLOGY,0,0,0,1,1
REVENUE GENERATION AND ECONOMIC REGULATION,0,0,0,1,1
THE GROUP AND ITS OWNERSHIP,0,0,0,1,1
CUSTOMERS,0,0,0,1,1
ROLE OF GOVERNMENT SERVICES AND AGENCIES IN AIRPORT OPERATIONS,0,0,0,1,1
UK AIRPORT CAPACITY,0,0,0,1,1
AERODROME LICENCES,0,0,0,1,1
4.** **COVENANTS,0,0,0,1,1
8.** **PAYMENTS,0,0,0,1,1
10.** **TAXATION,0,0,0,1,1
15.** **REPLACEMENT OF NOTES AND COUPONS,0,0,0,1,1
"16.** **MEETINGS OF NOTEHOLDERS, MODIFICATION, WAIVER AND AUTHORISATION",0,0,0,1,1
20.** **NOTICES,0,0,0,1,1
21.** **DEFINITIONS,0,0,0,1,1
SUMMARY HISTORICAL CONSOLIDATED FINANCIAL DATA,1,0,0,0,1
MERCATORUM,0,0,1,0,1
SUMMARY CORPORATE AND FINANCING STRUCTURE—POST-CLOSING REORGANISATION,0,0,0,1,1
CERTAIN TAX CONSIDERATIONS OECD COMMON REPORTING STANDARDS,0,0,0,1,1
ABOUT THIS PROSPECTUS,0,0,0,1,1
DATE”) THAT IS ONE YEAR AFTER THE LATER OF THE ORIGINAL ISSUE DATE HEREOF AND THE,0,0,0,1,1
BOARD,0,0,1,0,1
SUPER SENIOR REVOLVING CREDIT FACILITY,0,0,0,1,1
D.** **PRINCIPLES OF CONSOLIDATION,1,0,0,0,1
UNAUDITED PRO FORMA CONDENSED COMBINED STATEMENT OF OPERATIONS,0,0,0,1,1
PROFESSIONAL INVESTORS AND ECPS ONLY TARGET MARKET,0,0,0,1,1
TRANSACTION OVERVIEW:,0,0,0,1,1
PRINCIPAL TERMS OF THE NOTES:,0,0,0,1,1
DESCRIPTION OF THE RECEIVABLES,0,0,1,0,1
TAXATION THE NETHERLANDS,0,0,0,1,1
15.** **INFORMATION AND OTHER UNDERTAKINGS,0,0,0,1,1
SCHEDULE 7 ADDITIONAL DEFINITIONS,0,0,0,1,1
SUMMARY COMBINED FINANCIAL AND OTHER INFORMATION,1,0,0,0,1
DESCRIPTION OF DEBT SECURITIES,0,0,0,1,1
SECURITIES AND EXCHANGE COMMISSION REVIEW,0,0,0,1,1
EXCHANGE OFFER; REGISTRATION RIGHTS,0,0,0,1,1
INCORPORATION OF DOCUMENTS BY REFERENCE,0,0,0,1,1
SECURITY OWNERSHIP OF CERTAIN BENEFICIAL OWNERS,0,0,0,0,0
2.** **REVENUE,0,0,0,0,0
3.** **INVENTORIES,0,0,0,0,0
5.** **GOODWILL AND INTANGIBLE ASSETS—NET,0,0,0,0,0
6.** **COMPOSITION OF CERTAIN BALANCE SHEET ACCOUNTS,0,0,0,0,0
7.** **DEBT,0,0,0,0,0
11.** **SHARE BASED COMPENSATION,0,0,0,0,0
12.** **INCOME TAXES,0,0,0,0,0
3.** **ACQUISITIONS,0,0,0,0,0
6.** **GOODWILL AND INTANGIBLE ASSETS-NET,0,0,0,0,0
7.** **ACCRUED EXPENSES AND OTHER LIABILITIES,0,0,0,0,0
10.** **FAIR VALUE OF FINANCIAL INSTRUMENTS,0,0,0,0,0
11.** **SHARE-BASED COMPENSATION,0,0,0,0,0
12.** **EMPLOYEE BENEFIT PLANS,0,0,0,0,0
15.** **COMMITMENTS AND CONTINGENCIES,0,0,0,0,0
16.** **RELATED PARTY TRANSACTIONS,0,0,0,0,0
18.** **REVISION OF PREVIOUSLY REPORTED FINANCIAL INFORMATION,0,0,0,0,0
19.** **SUBSEQUENT EVENTS,0,0,0,0,0
NOTICE,0,0,0,0,0
BNP PARIBAS** **DEUTSCHE BANK SECURITIES CRÉDIT AGRICOLE CIB,0,0,0,0,0
ING UNICREDIT J.P. MORGAN BOFA SECURITIES SMBC NIKKO** **RBC CAPITAL MARKETS CITIGROUP** **MUFG,0,0,0,0,0
ERISA AND OTHER PLAN CONSIDERATIONS,0,0,0,0,0
MANAGER”) (OR PERSONS ACTING ON BEHALF OF THE STABILIZING MANAGER OR STABILIZING,0,0,0,0,0
IAS 1,0,0,0,0,0
"MARKET, ECONOMIC AND INDUSTRY DATA",0,0,0,0,0
TRADEMARKS AND TRADE NAMES,0,0,0,0,0
TAX CONSIDERATIONS,0,0,0,0,0
USE OF TERMS,0,0,0,0,0
CURRENCY PRESENTATION,0,0,0,0,0
SUMMARY HISTORICAL CONSOLIDATED FINANCIAL INFORMATION AND OTHER FINANCIAL AND OPERATING DATA,0,0,0,0,0
OTHER FINANCIAL DATA,0,0,0,0,0
AS ADJUSTED OTHER FINANCIAL DATA,0,0,0,0,0
LIMITATIONS ON VALIDITY AND ENFORCEABILITY OF GUARANTEES AND SECURITY AND CERTAIN INSOLVENCY LAW CONSIDERATIONS,0,0,0,0,0
STATUTORY AUDITORS,0,0,0,0,0
ENFORCEMENT OF CIVIL LIABILITIES,0,0,0,0,0
REGISTERED OFFICE OF THE ISSUER,0,0,0,0,0
LEGAL ADVISORS,0,0,0,0,0
SELECTED CONSOLIDATED FINANCIAL AND OTHER INFORMATION,0,0,0,0,0
WHERE YOU CAN FIND OTHER INFORMATION,0,0,0,0,0
"RECURRING OPERATING INCOME** . . . . . . . . . . . . . . . . . . . . . . . . . . . . . . . . . . . . **3,0",0,0,0,0,0
"OPERATING INCOME . . . . . . . . . . . . . . . . . . . . . . . . . . . . . . . . . . . . . . . . . . . . . . .** **3,0",0,0,0,0,0
"TOTAL NON-CURRENT ASSETS . . . . . . . . . . . . . . . . . . . . . . . . . . . . . . . . . . . .** **170,2",0,0,0,0,0
LEGAL ADVISORS TO THE ISSUER,0,0,0,0,0
NOTICE TO CANADIAN INVESTORS,0,0,0,0,0
NOTICE TO U.K. INVESTORS,0,0,0,0,0
CAGR,0,0,0,0,0
T€,0,0,0,0,0
2019 T€,0,0,0,0,0
I,0,0,0,0,0
OFFERING MEMORANDUM,0,0,0,0,0
PRELIMINARY OFFERING MEMORANDUM** **CONFIDENTIAL NOT FOR GENERAL CIRCULATION IN THE UNITED STATES,0,0,0,0,0
NOTICE TO INVESTORS IN THE UNITED KINGDOM,0,0,0,0,0
NOTICE REGARDING SERVICE OF PROCESS AND ENFORCEMENT OF JUDGMENTS,0,0,0,0,0
NOTES ON DEFINED TERMS USED IN THIS OFFERING MEMORANDUM,0,0,0,0,0
CORPORATE AND FINANCING STRUCTURE,0,0,0,0,0
SUMMARY CONSOLIDATED FINANCIAL AND OTHER DATA OF ARDAGH GROUP S.A.,0,0,0,0,0
MAJOR SHAREHOLDERS AND RELATED PARTY INFORMATION,0,0,0,0,0
LEGAL ADVISERS TO THE ISSUERS AND THE GUARANTORS,0,0,0,0,0
LEGAL ADVISERS TO THE INITIAL PURCHASER,0,0,0,0,0
EXTENDED SETTLEMENT,0,0,0,0,0
PRINCIPAL STOCKHOLDERS TIFS,0,0,0,0,0
CERTAIN INSOLVENCY LAW CONSIDERATIONS AND LIMITATIONS ON THE VALIDITY AND ENFORCEABILITY OF THE NOTES GUARANTEES,0,0,0,0,0
FTDS,0,0,0,0,0
LEGAL ADVISOR TO THE ISSUER,0,0,0,0,0
SUMMARY CONSOLIDATED FINANCIAL & OTHER DATA OF ARDAGH METAL PACKAGING S.A.,0,0,0,0,0
LEGAL ADVISERS TO THE INITIAL PURCHASERS,0,0,0,0,0
PRESENTATION OF FINANCIAL INFORMATION FINANCIAL INFORMATION RELATING TO THE HISTORIC LADBROKES GROUP,0,0,0,0,0
HISTORIC LADBROKES GROUP NON-IFRS MEASURES,0,0,0,0,0
FINANCIAL INFORMATION RELATING TO THE HISTORIC CORAL GROUP,0,0,0,0,0
HISTORIC CORAL GROUP NON-IFRS MEASURES,0,0,0,0,0
THE HISTORIC LADBROKES GROUP AND THE HISTORIC CORAL GROUP LBO FIGURES,0,0,0,0,0
DOCUMENTS INCORPORATED BY REFERENCE,0,0,0,0,0
RISKS RELATING TO THE NOTES AND CORPORATE STRUCTURE,0,0,0,0,0
CAPITALISATION TABLE,0,0,0,0,0
CONDITIONS OF THE NOTES,0,0,0,0,0
5.7** **FATCA,0,0,0,0,0
SUMMARY OF PROVISIONS RELATING TO THE NOTES WHILE REPRESENTED BY THE GLOBAL NOTES,0,0,0,0,0
1.** **EXCHANGE,0,0,0,0,0
2.** **PAYMENTS,0,0,0,0,0
3.** **NOTICES,0,0,0,0,0
4.** **ACCOUNTHOLDERS,0,0,0,0,0
5.** **PRESCRIPTION,0,0,0,0,0
6.** **CANCELLATION,0,0,0,0,0
7.** **PUT OPTION,0,0,0,0,0
8.** **REDEMPTION AT THE OPTION OF THE ISSUER,0,0,0,0,0
"9.** **EUROCLEAR AND CLEARSTREAM, LUXEMBOURG",0,0,0,0,0
GENERAL INFORMATION 1.** **LISTING AND ADMISSION TO TRADING,0,0,0,0,0
2.** **AUTHORISATION,0,0,0,0,0
3.** **CLEARING SYSTEMS,0,0,0,0,0
4.** **NO SIGNIFICANT CHANGE,0,0,0,0,0
6.** **MATERIAL CONTRACTS,0,0,0,0,0
7.** **AUDITORS,0,0,0,0,0
8.** **US TAX,0,0,0,0,0
9.** **DOCUMENTS AVAILABLE FOR INSPECTION,0,0,0,0,0
10.** **YIELD,0,0,0,0,0
11.** **BOOKRUNNERS TRANSACTING WITH THE ISSUER AND THE GUARANTOR,0,0,0,0,0
DEFINITIONS,0,0,0,0,0
REGISTERED OFFICE OF THE ISSUER AND THE GUARANTOR,0,0,0,0,0
LEGAL ADVISERS,0,0,0,0,0
AUDITORS,0,0,0,0,0
JOINT ACTIVE LEAD BOOKRUNNERS,0,0,0,0,0
JOINT LEAD BOOKRUNNER,0,0,0,0,0
STATEMENTS REGARDING FORWARD LOOKING INFORMATION,0,0,0,0,0
CERTAIN UNITED STATES FEDERAL TAX CONSEQUENCES TO NON-U.S. HOLDERS,0,0,0,0,0
EXPERTS,0,0,0,0,0
"THE SECURITIES OFFERED HEREBY HAVE NOT BEEN RECOMMENDED BY ANY UNITED STATES FEDERAL OR STATE SECURITIES COMMISSION OR REGULATORY AUTHORITY. FURTHERMORE, THE FOREGOING AUTHORITIES HAVE NOT CONFIRMED THE ACCURACY OR DETERMINED THE ADEQUACY OF THIS DOCUMENT. ANY REPRESENTATION TO THE CONTRARY IS A CRIMINAL OFFENSE.",0,0,0,0,0
RELATED PARTY TRANSACTIONS,0,0,0,0,0
VALIDITY OF THE NOTES,0,0,0,0,0
CURRENT ASSETS,0,0,0,0,0
SHAREHOLDERS’ EQUITY (DEFICIT) AND LIABILITIES EQUITY (DEFICIT),0,0,0,0,0
LIABILITIES,0,0,0,0,0
NET CASH FLOW FROM INVESTING ACTIVITIES,0,0,0,0,0
NET CASH FLOW FROM FINANCING ACTIVITIES,0,0,0,0,0
3.** **SEGMENT REPORTING,0,0,0,0,0
4.** **REVENUE FROM CONTRACTS WITH CUSTOMERS,0,0,0,0,0
CONTRACT BALANCES,0,0,0,0,0
5.** **PENSIONS,0,0,0,0,0
8.** **INCOME TAXES,0,0,0,0,0
9.** **INTANGIBLE ASSETS,0,0,0,0,0
12.** **SHAREHOLDERS’ EQUITY (DEFICIT),0,0,0,0,0
18.** **DISCONTINUED OPERATIONS AND ASSETS AND LIABILITIES HELD FOR SALE,0,0,0,0,0
19.** **LOSS PER SHARE,0,0,0,0,0
TOTAL SHAREHOLDERS’ EQUITY (DEFICIT) AND,0,0,0,0,0
STATEMENT OF LOSS AND OTHER COMPREHENSIVE INCOME AND LOSS DATA:,0,0,0,0,0
4.** **SEGMENT REPORTING,0,0,0,0,0
5.** **REVENUE FROM CONTRACTS WITH CUSTOMERS,0,0,0,0,0
8.** **PENSIONS,0,0,0,0,0
16.** **VALUATION PROVISIONS OF INVENTORIES,0,0,0,0,0
18.** **SHAREHOLDERS’ EQUITY (DEFICIT),0,0,0,0,0
22.** **LEASES,0,0,0,0,0
26.** **RELATED PARTY TRANSACTIONS,0,0,0,0,0
28.** **FINANCIAL RISK MANAGEMENT,0,0,0,0,0
COMMODITY PRICE RISK,0,0,0,0,0
INFLATION RISK,0,0,0,0,0
FUNDING RISK,0,0,0,0,0
LIQUIDITY RISK,0,0,0,0,0
CURRENCY RISK,0,0,0,0,0
INTEREST RISK,0,0,0,0,0
CREDIT RISK,0,0,0,0,0
CAPITAL MANAGEMENT,0,0,0,0,0
OFFSETTING FINANCIAL ASSETS AND LIABILITIES,0,0,0,0,0
29.** **DISCONTINUED OPERATIONS AND ASSETS AND LIABILITIES HELD FOR SALE,0,0,0,0,0
CURRENT LIABILITIES,0,0,0,0,0
30.** **LOSS PER SHARE,0,0,0,0,0
NO REVIEW BY THE SEC; NO REGISTRATION RIGHTS,0,0,0,0,0
MARKET AND INDUSTRY DATA AND FORECASTS,0,0,0,0,0
EXCHANGE RATES,0,0,0,0,0
CORPORATE INFORMATION,0,0,0,0,0
CONFIDENTIAL** **NOT FOR GENERAL DISTRIBUTION PRELIMINARY OFFERING MEMORANDUM** **IN THE UNITED STATES,0,0,0,0,0
NOTICE TO CERTAIN CANADIAN INVESTORS,0,0,0,0,0
CERTAIN DEFINITIONS USED IN THIS OFFERING MEMORANDUM,0,0,0,0,0
SUMMARY HISTORICAL CONSOLIDATED FINANCIAL INFORMATION AND OTHER DATA,0,0,0,0,0
LIMITATIONS ON VALIDITY AND ENFORCEABILITY OF THE NOTE GUARANTEES AND THE SECURITY INTERESTS AND CERTAIN INSOLVENCY LAW CONSIDERATIONS,0,0,0,0,0
INDEPENDENT AUDITOR,0,0,0,0,0
CLASSES AND CATEGORIES OF FINANCIAL INSTRUMENTS AND THEIR FAIR VALUES,0,0,0,0,0
PARTIAL REPAYMENT OF TERM LOAN A DUE MAY 2026,0,0,0,0,0
TRANSLATION,0,0,0,0,0
OTHER MATTER – USE OF THE AUDITOR’S REPORT,0,0,0,0,0
NOTE ON THE SUPPLEMENTARY AUDIT,0,0,0,0,0
GERMAN PUBLIC AUDITOR RESPONSIBLE FOR THE ENGAGEMENT,0,0,0,0,0
BASIS OF ACCOUNTING,0,0,0,0,0
BASIS OF CONSOLIDATION,0,0,0,0,0
BUSINESS COMBINATIONS,0,0,0,0,0
GOODWILL,0,0,0,0,0
INVESTMENTS IN ASSOCIATES,0,0,0,0,0
REVENUE,0,0,0,0,0
LEASES,0,0,0,0,0
FOREIGN CURRENCIES,0,0,0,0,0
CINVEN LIMITED: NON-BINDING EXPRESSION OF INTEREST,0,0,0,0,0
SWEDEN,0,0,0,0,0
ITALY,0,0,0,0,0
GERMANY,0,0,0,0,0
SPAIN & GIBRALTAR,0,0,0,0,0
LATAM,0,0,0,0,0
BELGIUM,0,0,0,0,0
PORTUGAL,0,0,0,0,0
SWITZERLAND,0,0,0,0,0
AUSTRIA,0,0,0,0,0
CZECH REPUBLIK & SLOVAKIA,0,0,0,0,0
ESTONIA & LITHUANIA,0,0,0,0,0
DENMARK,0,0,0,0,0
FINLAND,0,0,0,0,0
HUNGARY,0,0,0,0,0
EMERGING MARKETS,0,0,0,0,0
UK & IRELAND,0,0,0,0,0
RESPONSIBLE GERMAN PUBLIC AUDITOR,0,0,0,0,0
ACQUISITIONS,0,0,0,0,0
INTEREST RATE CAP DERIVATIVE,0,0,0,0,0
BELARUS AND UKRAINE,0,0,0,0,0
REST OF WORLD,0,0,0,0,0
ROUNDING,0,0,0,0,0
BASIS OF PRESENTATION AND OTHER INFORMATION,0,0,0,0,0
NO SEC REVIEW; NO REGISTRATION RIGHTS,0,0,0,0,0
TRADEMARKS AND TRADENAMES,0,0,0,0,0
CERTAIN U.S. FEDERAL INCOME TAX CONSEQUENCES,0,0,0,0,0
WHERE YOU CAN FIND ADDITIONAL INFORMATION; INCORPORATION BY REFERENCE,0,0,0,0,0
UNAUDITED PRO FORMA CONSOLIDATED FINANCIAL INFORMATION,0,0,0,0,0
CERTAIN VOLCKER RULE CONSIDERATIONS,0,0,0,0,0
CORPORATE STRUCTURE AND CERTAIN FINANCING ARRANGEMENTS,0,0,0,0,0
SUMMARY CONSOLIDATED FINANCIAL AND OTHER INFORMATION OF THE GROUP,0,0,0,0,0
SELECTED GROUP CONSOLIDATED FINANCIAL INFORMATION,0,0,0,0,0
MANAGEMENT’S DISCUSSION AND ANALYSIS OF THE GROUP’S FINANCIAL CONDITION AND RESULTS OF OPERATIONS,0,0,0,0,0
INDEX TO FINANCIAL INFORMATION,0,0,0,0,0
5.** **GOODWILL (CONTINUED),0,0,0,0,0
UK CGU,0,0,0,0,0
DACH CGU,0,0,0,0,0
11.** **SHARE BASED PAYMENTS,0,0,0,0,0
NORDICS CGU,0,0,0,0,0
33.** **SUBSEQUENT EVENTS,0,0,0,0,0
SELECTED HISTORICAL FINANCIAL DATA,0,0,0,0,0
LTIP 2015,0,0,0,0,0
LTIP 2016,0,0,0,0,0
LTIP 2017,0,0,0,0,0
CONFIDENTIAL** **NOT FOR GENERAL DISTRIBUTION OFFERING MEMORANDUM** **IN THE UNITED STATES,0,0,0,0,0
PRIIPS REGULATION,0,0,0,0,0
ERISA NOTICE,0,0,0,0,0
THIS** **OFFERING** **MEMORANDUM** **CONTAINS** **IMPORTANT** **INFORMATION** **THAT** **YOU SHOULD READ BEFORE YOU MAKE ANY DECISION WITH RESPECT TO AN INVESTMENT IN THE NOTES.,0,0,0,0,0
CURRENCY PRESENTATION AND OTHER DEFINITIONS,0,0,0,0,0
EXCHANGE RATE INFORMATION,0,0,0,0,0
CAPITALIZATION OF CWC,0,0,0,0,0
CAPITALIZATION OF THE ISSUER,0,0,0,0,0
THE ISSUER,0,0,0,0,0
DESCRIPTION OF THE NOTES (PRE-GROUP REFINANCING TRANSACTIONS),0,0,0,0,0
DESCRIPTION OF THE NOTES (POST-GROUP REFINANCING TRANSACTIONS),0,0,0,0,0
DESCRIPTION OF THE FOLD-IN NOTES (PRE-GROUP REFINANCING TRANSACTIONS),0,0,0,0,0
DESCRIPTION OF THE FOLD-IN NOTES (POST-GROUP REFINANCING TRANSACTIONS),0,0,0,0,0
CERTAIN EMPLOYEE BENEFIT PLAN CONSIDERATIONS,0,0,0,0,0
"PLAN INVESTOR”), OR (IV) A GOVERNMENTAL, CHURCH OR NON-U.S. PLAN WHICH IS SUBJECT",0,0,0,0,0
"FIDUCIARY”) WHO IS INDEPENDENT OF THE ISSUER AND ITS AFFILIATES, WHICH PLAN",0,0,0,0,0
ANNEX A,0,0,0,0,0
5.** **ISSUE OF SENIOR SECURED NOTES,0,0,0,0,0
6.** **ENTRY INTO PARI PASSU DEBT DOCUMENTS,0,0,0,0,0
29.** **NOTES TRUSTEE,0,0,0,0,0
30.** **COUNTERPARTS,0,0,0,0,0
31.** **GOVERNING LAW,0,0,0,0,0
SCHEDULE 2 FORM OF CREDITOR ACCESSION UNDERTAKING,0,0,0,0,0
SCHEDULE 3 FORM OF DEBTOR RESIGNATION REQUEST,0,0,0,0,0
SCHEDULE 10 EFFECTIVE DATE HEDGE COUNTERPARTIES,0,0,0,0,0
SIGNATORIES,0,0,0,0,0
ANNEX B,0,0,0,0,0
BETWEEN:,0,0,0,0,0
3.** **TURNOVER,0,0,0,0,0
7.** **DESIGNATION OF DEBT,0,0,0,0,0
13.** **THE SECURITY TRUSTEE,0,0,0,0,0
15.** **SEVERABILITY,0,0,0,0,0
16.** **COUNTERPARTS,0,0,0,0,0
17** **LIMITED RECOURSE,0,0,0,0,0
18.** **GOVERNING LAW,0,0,0,0,0
19.** **CONFLICTS,0,0,0,0,0
SCHEDULE 1 FORM OF ACCESSION AGREEMENT,0,0,0,0,0
ANNEX C PRELIMINARY FINANCIAL AND OPERATING DATA FOR THE SECOND QUARTER OF 2017,0,0,0,0,0
INDEPENDENT AUDITORS FOR CWC KPMG LLP (US),0,0,0,0,0
KPMG LLP (UK),0,0,0,0,0
"OFFERING MEMORANDUM , 2024",0,0,0,0,0
OFFERING MEMORANDUM NOT FOR GENERAL DISTRIBUTION IN THE UNITES STATES,0,0,0,0,0
NOTICE TO CERTAIN INVESTORS,0,0,0,0,0
THIS OFFERING MEMORANDUM CONTAINS IMPORTANT INFORMATION THAT YOU SHOULD READ BEFORE YOU MAKE ANY DECISION WITH RESPECT TO AN INVESTMENT IN THE NOTES.,0,0,0,0,0
CERTAIN DEFINITIONS AND GLOSSARY,0,0,0,0,0
SIMPLIFIED CORPORATE AND FINANCING STRUCTURE,0,0,0,0,0
SELECTED HISTORICAL CONSOLIDATED FINANCIAL AND OTHER DATA,0,0,0,0,0
MANAGEMENT DISCUSSION AND ANALYSIS OF FINANCIAL CONDITION AND RESULTS OF OPERATIONS,0,0,0,0,0
REGULATORY OVERVIEW,0,0,0,0,0
PRINCIPAL SHAREHOLDERS AND RELATED PARTY TRANSACTIONS,0,0,0,0,0
DATE”) THAT IS [RULE 144A NOTES: ONE YEAR AFTER THE LATER OF THE ORIGINAL ISSUE,0,0,0,0,0
ENFORCEMENT OF FOREIGN JUDGMENTS AND SERVICE OF PROCESS,0,0,0,0,0
ENFORCEM ENT OF FOREIGN JUDGMENTS AND SERVICE OF PROCESS,0,0,0,0,0
INDEPENDENT AUDITOR FOR THE ISSUER,0,0,0,0,0
"144A”) ONLY TO PERSONS THAT ARE QUALIFIED INSTITUTIONAL BUYERS (EACH, A “QIB”),",0,0,0,0,0
NOTICE TO GERMAN INVESTORS,0,0,0,0,0
NOTICE TO UK INVESTORS,0,0,0,0,0
THIS OFFERING MEMORANDUM CONTAINS IMPORTANT INFORMATION WHICH YOU SHOULD READ BEFORE YOU MAKE ANY DECISION WITH RESPECT TO AN INVESTMENT IN THE ADDITIONAL NOTES.,0,0,0,0,0
CURRENCY PRESENTATION AND EXCHANGE RATE INFORMATION,0,0,0,0,0
STRENGTHS,0,0,0,0,0
TRADING UPDATE,0,0,0,0,0
OVERVIEW OF THE GROUP’S CORPORATE AND FINANCING STRUCTURE,0,0,0,0,0
SUMMARY HISTORICAL FINANCIAL INFORMATION AND OTHER INFORMATION,0,0,0,0,0
SELECTED FINANCIAL INFORMATION,0,0,0,0,0
MANAGEMENT’S DISCUSSION AND ANALYSIS OF FINANCIAL CONDITION AND RESULTS OF OPERATIONS OF THE FORMER RENK AG GROUP AND RENK HOLDING GMBH GROUP,0,0,0,0,0
MANAGEMENT’S DISCUSSION AND ANALYSIS OF FINANCIAL CONDITION AND RESULTS OF OPERATIONS OF THE TARGET BUSINESS,0,0,0,0,0
INDUSTRY AND COMPETITION,0,0,0,0,0
BUSINESS OVERVIEW,0,0,0,0,0
R&D,0,0,0,0,0
SHAREHOLDERS,0,0,0,0,0
CERTAIN INSOLVENCY LAW CONSIDERATIONS AND LIMITATIONS ON THE VALIDITY AND ENFORCEABILITY OF THE GUARANTEES AND SECURITY INTERESTS,0,0,0,0,0
CERTAIN US FEDERAL INCOME TAX CONSIDERATIONS,0,0,0,0,0
"INVESTOR”), OR A GOVERNMENTAL, CHURCH OR NON-US PLAN WHICH IS SUBJECT",0,0,0,0,0
NOTE 3: CONTRACT ASSETS AND CONTRACT LIABILITIES,0,0,0,0,0
NOTE 4: INVENTORIES,0,0,0,0,0
"NOTE 5: PROPERTY, PLANT AND EQUIPMENT",0,0,0,0,0
NOTE 6: GOODWILL AND INTANGIBLE ASSETS,0,0,0,0,0
NOTE 9: LEASE COMMITMENTS,0,0,0,0,0
NOTE 10: ACCUMULATED OTHER COMPREHENSIVE INCOME (LOSS) (“AOCI”),0,0,0,0,0
NOTE 12: BACKLOG,0,0,0,0,0
NOTE 13: LEGAL PROCEEDINGS AND CONTINGENCIES,0,0,0,0,0
NOTE 15: SUBSEQUENT EVENTS,0,0,0,0,0
NOTE B: CONTRACT ASSETS AND CONTRACT LIABILITIES,0,0,0,0,0
NOTE C: INVENTORIES,0,0,0,0,0
"NOTE D: PROPERTY, PLANT AND EQUIPMENT",0,0,0,0,0
NOTE E: GOODWILL AND INTANGIBLE ASSETS,0,0,0,0,0
NOTE I: BACKLOG,0,0,0,0,0
NOTE J: LEGAL PROCEEDINGS AND CONTINGENCIES,0,0,0,0,0
NOTE L: SUBSEQUENT EVENTS,0,0,0,0,0
LEGAL ADVISORS TO THE INITIAL PURCHASER,0,0,0,0,0
"TRADEMARKS, SERVICE MARKS AND TRADE NAMES",0,0,0,0,0
BASIS OF FINANCIAL PRESENTATION AND OTHER INFORMATION,0,0,0,0,0
NON-GAAP METRICS,0,0,0,0,0
THIS OFFERING MEMORANDUM CONTAINS IMPORTANT INFORMATION WHICH YOU SHOULD READ BEFORE YOU MAKE ANY DECISION WITH RESPECT TO AN INVESTMENT IN THE NOTES.,0,0,0,0,0
EXCHANGE RATE AND CURRENCY INFORMATION,0,0,0,0,0
SUMMARY UNAUDITED PRO FORMA COMBINED FINANCIAL INFORMATION OF THE COMBINED GROUP,0,0,0,0,0
"SUMMARY OTHER FINANCIAL, OPERATIONAL AND AS ADJUSTED DATA OF THE COMBINED GROUP",0,0,0,0,0
SUMMARY CONSOLIDATED FINANCIAL AND OTHER INFORMATION FOR PURE GYM,0,0,0,0,0
SUMMARY CONSOLIDATED FINANCIAL AND OTHER INFORMATION FOR FITNESS WORLD,0,0,0,0,0
UNAUDITED PRO FORMA COMBINED FINANCIAL INFORMATION,0,0,0,0,0
MANAGEMENT’S DISCUSSION AND ANALYSIS OF FINANCIAL CONDITION AND RESULTS OF OPERATIONS OF PURE GYM,0,0,0,0,0
MANAGEMENT’S DISCUSSION AND ANALYSIS OF FINANCIAL CONDITION AND RESULTS OF OPERATIONS OF FITNESS WORLD,0,0,0,0,0
ENFORCEABILITY OF CIVIL LIABILITIES,0,0,0,0,0
CONSOLIDATED STATEMENT OF COMPREHENSIVE INCOME,0,0,0,0,0
CONSOLIDATED STATEMENT OF FINANCIAL POSITION,0,0,0,0,0
CONSOLIDATED CASH FLOW STATEMENT,0,0,0,0,0
CONSOLIDATED STATEMENT OF CHANGES IN EQUITY,0,0,0,0,0
NOTES TO THE CONSOLIDATED FINANCIAL STATEMENTS (CONTINUED),0,0,0,0,0
NOTES TO THE COMPANY FINANCIAL STATEMENTS (CONTINUED),0,0,0,0,0
INDEPENDENT AUDITORS' REPORT TO THE MEMBERS OF GYM TOPCO LIMITED,0,0,0,0,0
CONDENSED CONSOLIDATED STATEMENT OF COMPREHENSIVE INCOME,0,0,0,0,0
CONDENSED CONSOLIDATED STATEMENT OF FINANCIAL POSITION,0,0,0,0,0
CONDENSED CONSOLIDATED CASH FLOW STATEMENT,0,0,0,0,0
CONDENSED CONSOLIDATED STATEMENT OF CHANGES IN EQUITY,0,0,0,0,0
NOTES TO THE CONDENSED CONSOLIDATED INTERIM FINANCIAL STATEMENTS,0,0,0,0,0
LEGAL ADVISOR TO THE INITIAL PURCHASERS,0,0,0,0,0
LEGAL ADVISOR TO FITNESS WORLD,0,0,0,0,0
NOTICE TO RESIDENTS OF CANADA,0,0,0,0,0
THE OFFERINGS,0,0,0,0,0
DESCRIPTION OF THE SENIOR NOTES,0,0,0,0,0
CERTAIN LIMITATIONS ON VALIDITY AND ENFORCEABILITY OF THE NOTES GUARANTEES AND THE COLLATERAL AND CERTAIN INSOLVENCY LAW CONSIDERATIONS,0,0,0,0,0
REPORT OF THE REVISEUR D’ENTREPRISES AGREE,0,0,0,0,0
LEGAL ADVISORS TO THE ISSUERS,0,0,0,0,0
INDEPENDENT AUDITORS OF JAYHAWK KPMG LLP,0,0,0,0,0
PROSPECTIVE FINANCIAL INFORMATION,0,0,0,0,0
INDEPENDENT PUBLIC ACCOUNTING FIRM,0,0,0,0,0
"CLOUD SOFTWARE GROUP HOLDINGS, INC. CONSOLIDATED BALANCE SHEETS",0,0,0,0,0
"CLOUD SOFTWARE GROUP HOLDINGS, INC. CONSOLIDATED STATEMENTS OF OPERATIONS",0,0,0,0,0
"CLOUD SOFTWARE GROUP HOLDINGS, INC. CONSOLIDATED STATEMENTS OF COMPREHENSIVE LOSS",0,0,0,0,0
"CLOUD SOFTWARE GROUP HOLDINGS, INC. CONSOLIDATED STATEMENTS OF STOCKHOLDERS’/MEMBER’S EQUITY",0,0,0,0,0
"CLOUD SOFTWARE GROUP HOLDINGS, INC. CONSOLIDATED STATEMENTS OF CASH FLOWS",0,0,0,0,0
"CLOUD SOFTWARE GROUP HOLDINGS, INC. CONDENSED CONSOLIDATED BALANCE SHEETS",0,0,0,0,0
"CLOUD SOFTWARE GROUP HOLDINGS, INC. CONDENSED CONSOLIDATED STATEMENTS OF OPERATIONS",0,0,0,0,0
"CLOUD SOFTWARE GROUP HOLDINGS, INC. CONDENSED CONSOLIDATED STATEMENTS OF COMPREHENSIVE LOSS",0,0,0,0,0
"CLOUD SOFTWARE GROUP HOLDINGS, INC. CONDENSED CONSOLIDATED STATEMENTS OF CASH FLOWS",0,0,0,0,0
"CLOUD SOFTWARE GROUP HOLDINGS, INC. CONDENSED CONSOLIDATED STATEMENTS OF CASH FLOWS —(CONTINUED)",0,0,0,0,0
STADA,0,0,0,0,0
LEGAL ADVISORS TO THE SENIOR SECURED NOTES ISSUER,0,0,0,0,0
CONSOLIDATED INCOME STATEMENT FOR 2021,0,0,0,0,0
BALANCE SHEET,0,0,0,0,0
IDENTIFIED LIABILITIES,0,0,0,0,0
INDEPENDENT AUDITORS OF BOELS TOPHOLDING B.V.,0,0,0,0,0
BNP PARIBAS,0,0,0,0,0
CERTAIN UNAUDITED PRO FORMA COMBINED FINANCIAL DATA,0,0,0,0,0
CERTAIN HISTORICAL CONSOLIDATED FINANCIAL DATA OF JAZZ,0,0,0,0,0
CERTAIN HISTORICAL CONSOLIDATED FINANCIAL DATA OF GW,0,0,0,0,0
CERTAIN NON-GAAP FINANCIAL MEASURES,0,0,0,0,0
THE ACQUISITION,0,0,0,0,0
UNAUDITED PRO FORMA CONDENSED COMBINED FINANCIAL INFORMATION,0,0,0,0,0
LIABILITIES AND SHAREHOLDERS’ EQUITY,0,0,0,0,0
CERTAIN U.S. FEDERAL INCOME TAX CONSIDERATIONS FOR U.S. HOLDERS,0,0,0,0,0
"THE U.S. FEDERAL INCOME TAX DISCUSSION SET FORTH HEREIN IS INCLUDED FOR GENERAL INFORMATION ONLY, IS NOT TAX ADVICE AND MAY NOT BE APPLICABLE DEPENDING UPON A U.S. HOLDER’S PARTICULAR SITUATION. PROSPECTIVE U.S. HOLDERS SHOULD CONSULT THEIR OWN TAX ADVISORS REGARDING THE TAX CONSEQUENCES TO THEM OF THE PURCHASE, OWNERSHIP AND DISPOSITION OF THE NOTES, INCLUDING THE TAX CONSEQUENCES UNDER U.S. FEDERAL INCOME AND OTHER TAX LAWS, AS WELL AS UNDER STATE, LOCAL, NON-U.S. AND OTHER TAX LAWS (AND ANY PROPOSED CHANGES IN APPLICABLE LAW).",0,0,0,0,0
CERTAIN MATERIAL IRISH TAX CONSIDERATIONS,0,0,0,0,0
CERTAIN LUXEMBOURG TAX CONSIDERATIONS,0,0,0,0,0
INDEPENDENT REGISTERED PUBLIC ACCOUNTING FIRMS,0,0,0,0,0
UNITED STATES FEDERAL INCOME TAX CONSIDERATIONS,0,0,0,0,0
ANNEX A CERTAIN INSOLVENCY CONSIDERATIONS AND LIMITATIONS ON THE VALIDITY AND ENFORCEABILITY OF THE GUARANTEES,0,0,0,0,0
INDUSTRY AND MARKET INFORMATION,0,0,0,0,0
ENERGIZE-T,0,0,0,0,0
LIMITATIONS ON VALIDITY AND ENFORCEABILITY OF THE SECURITY INTERESTS AND GUARANTEES AND CERTAIN INSOLVENCY LAW CONSIDERATIONS,0,0,0,0,0
ACCOUNTING PRINCIPLES,0,0,0,0,0
A.** **THE COMPANY,0,0,0,0,0
B.** **BASIS OF PRESENTATION,0,0,0,0,0
D.** **ACCOUNTING POLICIES,0,0,0,0,0
A. THE COMPANY,0,0,0,0,0
B. BASIS OF PRESENTATION,0,0,0,0,0
D. ACCOUNTING POLICIES,0,0,0,0,0
REGISTERED OFFICE OF THE SENIOR SECURED NOTES ISSUER,0,0,0,0,0
LEGAL ADVISERS TO THE SENIOR SECURED NOTES ISSUER,0,0,0,0,0
"TRUSTEE AND SECURITY AGENT** **PAYING AGENT, TRANSFER AGENT AND REGISTRAR",0,0,0,0,0
INDEPENDENT AUDITORS OF GERMAN TOPCO,0,0,0,0,0
LISTING AGENT,0,0,0,0,0
LEGAL ADVISER TO THE TRUSTEE AND THE SECURITY AGENT,0,0,0,0,0
NOT FOR GENERAL DISTRIBUTION IN THE UNITED STATES,0,0,0,0,0
NOTICE TO INVESTORS IN THE UNITED STATES,0,0,0,0,0
CURRENCY AND EXCHANGE RATE INFORMATION,0,0,0,0,0
SELECTED HISTORICAL FINANCIAL INFORMATION,0,0,0,0,0
OUR SHAREHOLDER,0,0,0,0,0
LIMITATIONS ON THE VALIDITY AND ENFORCEABILITY OF THE NOTES GUARANTEES AND SECURITY INTERESTS AND CERTAIN INSOLVENCY LAW CONSIDERATIONS,0,0,0,0,0
INDEX TO FINANCIAL STATEMENTS,0,0,0,0,0
OMERS,0,0,0,0,0
SUMMARY HISTORICAL FINANCIAL INFORMATION AND OPERATING DATA,0,0,0,0,0
LIMITATIONS ON VALIDITY AND ENFORCEABILITY OF THE GUARANTEES AND THE COLLATERAL AND CERTAIN INSOLVENCY LAW CONSIDERATIONS,0,0,0,0,0
PLN ‘000,0,0,0,0,0
"THIS OFFERING MEMORANDUM CONTAINS IMPORTANT INFORMATION, WHICH YOU SHOULD READ BEFORE YOU MAKE ANY DECISION WITH RESPECT TO AN INVESTMENT IN THE NOTES.",0,0,0,0,0
OUR CORPORATE STRUCTURE,0,0,0,0,0
SUMMARY HISTORICAL FINANCIAL DATA,0,0,0,0,0
LIMITATIONS ON VALIDITY AND ENFORCEABILITY OF THE GUARANTEES AND SECURITY INTERESTS AND CERTAIN INSOLVENCY LAW CONSIDERATIONS,0,0,0,0,0
GLOSSARY,0,0,0,0,0
ISSUER PRESTIGEBIDCO GMBH,0,0,0,0,0
LEGAL ADVISORS TO THE TRUSTEE,0,0,0,0,0
LEGAL ADVISORS TO THE SECURITY AGENT,0,0,0,0,0
NOTICE TO PROSPECTIVE INVESTORS IN THE UNITED STATES,0,0,0,0,0
CURRENCIES AND EXCHANGE RATES,0,0,0,0,0
SUMMARY HISTORICAL FINANCIAL AND OTHER INFORMATION,0,0,0,0,0
UNAUDITED NON-GAAP AGGREGATED FINANCIAL INFORMATION,0,0,0,0,0
CERTAIN TAXATION CONSIDERATIONS,0,0,0,0,0
IFRS 15,0,0,0,0,0
IFRS 9,0,0,0,0,0
TRUSTEE** **PAYING AGENT AND TRANSFER AGENT,0,0,0,0,0
SECURITY AGENT** **REGISTRAR** **LISTING AGENT,0,0,0,0,0
EMTN PROGRAMME PROSPECTUS,0,0,0,0,0
GENERAL DESCRIPTION OF THE PROGRAMME,0,0,0,0,0
FORM OF THE NOTES,0,0,0,0,0
PROVISIONS RELATING TO INTEREST (IF ANY) PAYABLE,0,0,0,0,0
PROVISIONS RELATING TO REDEMPTION,0,0,0,0,0
GENERAL PROVISIONS APPLICABLE TO THE NOTES,0,0,0,0,0
THIRD PARTY INFORMATION,0,0,0,0,0
6.** **OPERATIONAL INFORMATION,0,0,0,0,0
7.** **DISTRIBUTION,0,0,0,0,0
"1.** **FORM, DENOMINATION AND TITLE",0,0,0,0,0
9.** **PRESCRIPTION,0,0,0,0,0
"11.** **REPLACEMENT OF NOTES, COUPONS AND TALONS",0,0,0,0,0
12.** **AGENTS,0,0,0,0,0
13.** **EXCHANGE OF TALONS,0,0,0,0,0
16.** **INDEMNIFICATION OF THE TRUSTEE AND TRUSTEE CONTRACTING WITH THE ISSUER AND/OR THE GUARANTOR,0,0,0,0,0
17.** **FURTHER ISSUES,0,0,0,0,0
2.** **THE ITALIAN REGULATORY FRAMEWORK,0,0,0,0,0
6.** **RETAIL MARKETS,0,0,0,0,0
7.** **QUALITY OF SERVICES,0,0,0,0,0
10.** **BROADBAND AND DIGITAL DIVIDE,0,0,0,0,0
PRESENTATION OF FINANCIAL AND OTHER DATA,0,0,0,0,0
DEFINED TERMS,0,0,0,0,0
PRINCIPAL SHAREHOLDER,0,0,0,0,0
SUMMARY HISTORICAL CONSOLIDATED AND COMBINED FINANCIAL INFORMATION,0,0,0,0,0
"MEMORANDUM”) FOLLOWING THIS NOTICE, WHETHER RECEIVED BY EMAIL OR OTHERWISE RECEIVED",0,0,0,0,0
USE OF TERMS AND CONVENTIONS,0,0,0,0,0
FORWARD LOOKING STATEMENTS,0,0,0,0,0
SUMMARY FINANCIAL INFORMATION AND OTHER DATA,0,0,0,0,0
OPERATING AND FINANCIAL REVIEW AND PROSPECTS,0,0,0,0,0
"GRUPO ANTOLIN-IRAUSA, S.A.U. AND SUBSIDIARIES",0,0,0,0,0
2023 CONTINUING OPERATIONS:,0,0,0,0,0
"PROFIT FROM ORDINARY CONTINUING OPERATIONS** **92,633",0,0,0,0,0
"OPERATING PROFIT (LOSS) FROM CONTINUING OPERATIONS** **55,548",0,0,0,0,0
"PROFIT (LOSS) FOR THE YEAR FROM CONTINUING OPERATIONS** **12,587",0,0,0,0,0
ASSETS-,0,0,0,0,0
DISCONTINUED OPERATIONS:,0,0,0,0,0
"PRO FIT /(LO SS) FRO M O RD IN ARY CO N T IN U IN G O PERAT IO N S** **16,375",0,0,0,0,0
LEGAL ADVISORS TO THE COMPANY,0,0,0,0,0
TRADEMARKS AND COPYRIGHTS,0,0,0,0,0
UNAUDITED PRO FORMA FINANCIAL INFORMATION OF PETSMART,0,0,0,0,0
SECURITY OWNERSHIP,0,0,0,0,0
INDEPENDENT AUDITORS’ REPORT,0,0,0,0,0
"ALSO A QUALIFIED PURCHASER AS DEFINED IN THE INVESTMENT COMPANY ACT THAT PURCHASES FOR ITS OWN ACCOUNT OR FOR THE ACCOUNT OF A QUALIFIED INSTITUTIONAL BUYER THAT IS ALSO A QUALIFIED PURCHASER TO WHOM NOTICE IS GIVEN THAT THE TRANSFER IS BEING MADE IN RELIANCE ON RULE 144A, (D) PURSUANT TO OFFERS AND SALES THAT OCCUR OUTSIDE THE UNITED STATES IN COMPLIANCE WITH REGULATION S UNDER THE U.S. SECURITIES ACT OR (E) PURSUANT TO ANY OTHER AVAILABLE EXEMPTION FROM THE REGISTRATION REQUIREMENTS OF THE U.S. SECURITIES ACT, SUBJECT IN EACH OF THE FOREGOING CASES TO ANY REQUIREMENT OF LAW THAT THE DISPOSITION OF ITS PROPERTY OR THE PROPERTY OF SUCH INVESTOR ACCOUNT OR ACCOUNTS BE AT ALL TIMES WITHIN ITS OR THEIR CONTROL AND TO COMPLIANCE WITH ANY APPLICABLE STATE SECURITIES LAWS, AND ANY APPLICABLE LOCAL LAWS AND REGULATIONS AND FURTHER SUBJECT TO THE ISSUER’S AND THE TRUSTEE’S RIGHTS PRIOR TO ANY SUCH OFFER, SALE OR TRANSFER (I) PURSUANT TO CLAUSE (D) OR (E) TO REQUIRE THE DELIVERY OF AN OPINION OF COUNSEL, CERTIFICATION AND/OR OTHER INFORMATION SATISFACTORY TO EACH OF THEM, (II) IN EACH OF THE FOREGOING CASES, TO REQUIRE THAT A CERTIFICATE OF TRANSFER IN THE FORM APPEARING ON THE OTHER SIDE OF THIS SECURITY IS COMPLETED AND DELIVERED BY THE TRANSFEROR TO THE TRUSTEE AND (III) AGREES THAT IT WILL GIVE TO EACH PERSON TO WHOM THIS SECURITY IS TRANSFERRED A NOTICE SUBSTANTIALLY TO THE EFFECT OF THIS LEGEND. THIS LEGEND WILL BE REMOVED UPON THE REQUEST OF THE HOLDER AFTER THE RESALE RESTRICTION TERMINATION DATE.",0,0,0,0,0
INDEPENDENT AUDITORS KPMG LLP,0,0,0,0,0
SUMMARY CONSOLIDATED HISTORICAL FINANCIAL AND OTHER DATA,0,0,0,0,0
SELECTED CONSOLIDATED HISTORICAL AND OTHER FINANCIAL DATA,0,0,0,0,0
DESCRIPTION OF CERTAIN INDEBTEDNESS,0,0,0,0,0
DESCRIPTION OF SENIOR NOTES,0,0,0,0,0
GENERAL,0,0,0,0,0
INSOLVENCY CONSIDERATIONS AND LIMITATIONS ON VALIDITY AND ENFORCEABILITY OF THE GUARANTEES AND THE COLLATERAL,0,0,0,0,0
TERMINATION DATE”) WHICH IS [IN THE CASE OF RULE 144A NOTES: ONE YEAR AFTER THE,0,0,0,0,0
NON-IFRS MEASURES,0,0,0,0,0
ANNEX A—SUMMARY OF CERTAIN DIFFERENCES BETWEEN IFRS AND U.S. GAAP,0,0,0,0,0
US GAAP,0,0,0,0,0
IFRS,0,0,0,0,0
PRELIMINARY OFFERING MEMORANDUM,0,0,0,0,0
OFFERING MEMORANDUM** **NOT FOR GENERAL DISTRIBUTION IN THE UNITED STATES,0,0,0,0,0
CERTAIN CONSIDERATIONS REGARDING SALES INTO CANADA,0,0,0,0,0
GLOSSARY OF SELECTED TERMS,0,0,0,0,0
SUMMARY HISTORICAL AND CERTAIN OTHER FINANCIAL DATA,0,0,0,0,0
CERTAIN INSOLVENCY LAW CONSIDERATIONS AND LIMITATIONS ON THE VALIDITY AND ENFORCEABILITY OF THE GUARANTEE AND THE SECURITY INTERESTS,0,0,0,0,0
A) NON-CURRENT ASSETS,0,0,0,0,0
D) SHAREHOLDERS’ EQUITY,0,0,0,0,0
A) TOTAL REVENUES,0,0,0,0,0
ADJUSTED EBITDA,0,0,0,0,0
COVENANTS,0,0,0,0,0
INCOME STATEMENT,0,0,0,0,0
REPORT ON OTHER LEGAL AND REGULATORY REQUIREMENTS,0,0,0,0,0
•** **1.2 ACQUISITIONS FOR THE YEAR,0,0,0,0,0
•** **1.3 PURCHASE OF INVESTMENTS IN SUBSIDIARIES,0,0,0,0,0
•** **1.4 HYPERINFLATION IN ARGENTINA,0,0,0,0,0
•** **CRITICAL JUDGMENTS IN APPLYING THE ACCOUNTING POLICES,0,0,0,0,0
•** **KEY SOURCES OF ESTIMATION UNCERTAINTY,0,0,0,0,0
•** **3.2 ASSOCIATED COMPANIES,0,0,0,0,0
•** **3.3 JOINT ARRANGEMENTS,0,0,0,0,0
•** **3.4 CONSOLIDATION SCOPE,0,0,0,0,0
"•** **4.1 PROPERTY, PLANT AND EQUIPMENT",0,0,0,0,0
•** **4.4 GOODWILL,0,0,0,0,0
•** **4.5 LOSS IN VALUE OF AN ASSET (IMPAIRMENT),0,0,0,0,0
•** **4.6 BUSINESS COMBINATIONS,0,0,0,0,0
•** **4.7 EQUITY INVESTMENTS,0,0,0,0,0
•** **4.8 OTHER NON-CURRENT ASSETS,0,0,0,0,0
•** **4.9 INVENTORIES,0,0,0,0,0
•** **4.10 CUSTOMER CONTRACT ASSETS,0,0,0,0,0
•** **4.11 DEFERRED CONTRACT COSTS,0,0,0,0,0
•** **4.12 TRADE RECEIVABLES,0,0,0,0,0
•** **4.13 CASH AND CASH EQUIVALENTS,0,0,0,0,0
•** **4.14 DISCONTINUED OPERATIONS,0,0,0,0,0
•** **4.15 SHARE CAPITAL,0,0,0,0,0
•** **4.16 RESERVES,0,0,0,0,0
•** **4.17 RETAINED EARNINGS/(LOSSES CARRIED FORWARD),0,0,0,0,0
•** **4.18 FINANCIAL LIABILITIES,0,0,0,0,0
•** **4.19 TREATMENT OF THE PUT OPTIONS ON SUBSIDIARY SHARES,0,0,0,0,0
"•** **4.21 PROVISIONS FOR RISKS, CONTINGENT LIABILITIES AND CONTINGENT ASSETS",0,0,0,0,0
•** **4.23 GRANTS,0,0,0,0,0
•** **4.24 DEFERRED AND CURRENT TAXES,0,0,0,0,0
•** **4.27 FINANCIAL RISK AND CAPITAL MANAGEMENT,0,0,0,0,0
•** **4.28 RELATED PARTIES,0,0,0,0,0
•** **4.29 NEW IFRS AND IFRIC INTERPRETATIONS,0,0,0,0,0
•** **COMMITMENTS UNDERTAKEN,0,0,0,0,0
BOARD OF STATUTORY AUDITORS,0,0,0,0,0
DIRECTOR IN CHARGE OF THE INTERNAL CONTROL AND RISK MANAGEMENT SYSTEM,0,0,0,0,0
SUPERVISORY BOARD,0,0,0,0,0
1.3 PURCHASE OF INVESTMENTS IN SUBSIDIARIES,0,0,0,0,0
USE OF ESTIMATES AND MEASUREMENTS,0,0,0,0,0
3.2 ASSOCIATES,0,0,0,0,0
3.3 JOINT ARRANGEMENTS,0,0,0,0,0
"4.1 PROPERTY, PLANT AND EQUIPMENT",0,0,0,0,0
4.3 INTANGIBLE ASSETS,0,0,0,0,0
4.4 GOODWILL,0,0,0,0,0
4.6 BUSINESS COMBINATIONS,0,0,0,0,0
4.7 OTHER EQUITY INVESTMENTS,0,0,0,0,0
4.8 OTHER NON-CURRENT ASSETS,0,0,0,0,0
4.10 CUSTOMER CONTRACT ASSETS,0,0,0,0,0
4.13 CASH AND CASH EQUIVALENTS,0,0,0,0,0
4.14 DISCONTINUED OPERATIONS,0,0,0,0,0
4.15 SHARE CAPITAL,0,0,0,0,0
4.16 RESERVES,0,0,0,0,0
4.18 BORROWINGS,0,0,0,0,0
4.19 TREATMENT OF THE PUT OPTIONS ON SUBSIDIARY SHARES,0,0,0,0,0
"4.21 PROVISIONS FOR RISKS, CONTINGENT LIABILITIES AND CONTINGENT ASSETS",0,0,0,0,0
4.23 GRANTS,0,0,0,0,0
4.24 DEFERRED AND CURRENT TAXES,0,0,0,0,0
4.27 FINANCIAL RISK AND CAPITAL MANAGEMENT,0,0,0,0,0
•** **4.29 NEW IFRS STANDARDS AND IFRIC INTERPRETATIONS,0,0,0,0,0
4.30 SEASONALITY OF GROUP OPERATIONS,0,0,0,0,0
•** **OPERATING LEASES,0,0,0,0,0
•** **1.1 SIGNIFICANT OPERATIONS,0,0,0,0,0
•** **4.3 INTANGIBLE ASSETS,0,0,0,0,0
•** **4.10 CONSTRUCTION CONTRACTS,0,0,0,0,0
•** **4.11 TRADE RECEIVABLES,0,0,0,0,0
•** **4.12 CASH AND CASH EQUIVALENTS,0,0,0,0,0
•** **4.13 DISCONTINUED OPERATIONS,0,0,0,0,0
•** **4.14 SHARE CAPITAL,0,0,0,0,0
•** **4.15 RESERVES,0,0,0,0,0
•** **4.16 RETAINED EARNINGS/(LOSSES CARRIED FORWARD),0,0,0,0,0
•** **4.17 FINANCIAL LIABILITIES,0,0,0,0,0
"•** **4.19 PROVISIONS FOR RISKS, CONTINGENT LIABILITIES AND CONTINGENT ASSETS",0,0,0,0,0
•** **4.20 REVENUES AND COSTS,0,0,0,0,0
•** **4.21 GRANTS,0,0,0,0,0
•** **4.22 DEFERRED AND CURRENT TAXES,0,0,0,0,0
•** **4.25 RISK AND CAPITAL MANAGEMENT,0,0,0,0,0
•** **4.26 RELATED PARTIES,0,0,0,0,0
OPERATING LEASES,0,0,0,0,0
"IMPORTANT NOTICE THIS OFFERING IS AVAILABLE ONLY TO INVESTORS WHO ARE NOT U.S. PERSONS (AS DEFINED IN REGULATION S UNDER THE U.S. SECURITIES ACT) AND WHO ARE OUTSIDE THE UNITED STATES IN ACCORDANCE WITH REGULATION S (‘‘REGULATION S’’) UNDER THE U.S. SECURITIES ACT (AND, IF INVESTORS ARE RESIDENT IN A MEMBER STATE OF THE EUROPEAN ECONOMIC AREA OR THE UNITED KINGDOM, NOT A RETAIL INVESTOR).",0,0,0,0,0
SELECTED HISTORICAL CONSOLIDATED FINANCIAL INFORMATION,0,0,0,0,0
"DATE’’) WHICH IS 40 DAYS AFTER THE LATER OF THE ORIGINAL ISSUE DATE HEREOF,",0,0,0,0,0
OTHER INFORMATION,0,0,0,0,0
OUR OPINION ON OTHER MATTERS PRESCRIBED BY THE COMPANIES ACT 2006 IS UNMODIFIED,0,0,0,0,0
MATTERS ON WHICH WE ARE REQUIRED TO REPORT UNDER THE COMPANIES ACT 2006,0,0,0,0,0
MATTERS ON WHICH WE ARE REQUIRED TO REPORT BY EXCEPTION,0,0,0,0,0
RESPONSIBILITIES OF DIRECTORS FOR THE FINANCIAL STATEMENTS,0,0,0,0,0
AUDITOR’S RESPONSIBILITIES FOR THE AUDIT OF THE FINANCIAL STATEMENTS,0,0,0,0,0
USE OF OUR REPORT,0,0,0,0,0
BASIS OF PREPARATION,0,0,0,0,0
INVESTMENTS IN SUBSIDIARIES AND ASSOCIATES HELD BY THE COMPANY,0,0,0,0,0
INTERNATIONAL FINANCIAL REPORTING STANDARDS (IFRS) ADOPTED FOR THE FIRST TIME IN THE YEAR,0,0,0,0,0
IFRS16 ‘LEASES’,0,0,0,0,0
7. EARNINGS PER SHARE,0,0,0,0,0
14. TRADE AND OTHER RECEIVABLES,0,0,0,0,0
15. TRADE AND OTHER PAYABLES,0,0,0,0,0
16. OTHER FINANCIAL LIABILITIES,0,0,0,0,0
24. DISCONTINUED OPERATIONS,0,0,0,0,0
27. KEY SOURCES OF ESTIMATION UNCERTAINTY,0,0,0,0,0
28. RELATED PARTIES,0,0,0,0,0
29. POST BALANCE SHEET EVENTS,0,0,0,0,0
DISTRIBUTION,0,0,0,0,0
PURPOSE OF FINAL TERMS,0,0,0,0,0
RESPONSIBILITY,0,0,0,0,0
ISSUE/OFFER,0,0,0,0,0
EXPENSES,0,0,0,0,0
"INDEX/FORMULA/OTHER VARIABLE, EXPLANATION OF EFFECT ON VALUE OF INVESTMENT** **AND** **ASSOCIATED** **RISKS** **AND** **OTHER** **INFORMATION CONCERNING THE UNDERLYING",0,0,0,0,0
REGISTERED OFFICE OF THE ISSUER TDC A/S,0,0,0,0,0
SUMMARY CONSOLIDATED HISTORICAL AND OTHER FINANCIAL DATA,0,0,0,0,0
LIMITATIONS ON VALIDITY AND ENFORCEABILITY OF THE NOTES GUARANTEES AND THE SECURITY INTERESTS,0,0,0,0,0
NON CURRENT ASSETS,0,0,0,0,0
NON- CURRENT LIABILITIES,0,0,0,0,0
EQUITY,0,0,0,0,0
INVESTING ACTIVITIES,0,0,0,0,0
FINANCING ACTIVITIES,0,0,0,0,0
2   SIGNIFICANT ACCOUNTING POLICIES (CONTINUED),0,0,0,0,0
3** **CRITICAL ACCOUNTING JUDGEMENTS AND ESTIMATION UNCERTAINTIES,0,0,0,0,0
8** **NON-UNDERLYING ITEMS,0,0,0,0,0
12** **INCOME TAX,0,0,0,0,0
16** **RIGHT OF USE ASSETS,0,0,0,0,0
19** **LEASE LIABILITIES (CONTINUED),0,0,0,0,0
23** **SHARE BASED PAYMENTS,0,0,0,0,0
25  CAPITAL COMMITMENTS,0,0,0,0,0
26 RELATED PARTY TRANSACTIONS AND ULTIMATE CONTROLLING PARTY,0,0,0,0,0
28  POST BALANCE SHEET EVENTS,0,0,0,0,0
24** **CAPITAL COMMITMENTS,0,0,0,0,0
26** **RELATED PARTY TRANSACTIONS AND ULTIMATE CONTROLLING PARTY,0,0,0,0,0
28** **POST BALANCE SHEET EVENTS,0,0,0,0,0
15** **RIGHT OF USE ASSETS,0,0,0,0,0
23** **CAPITAL COMMITMENTS,0,0,0,0,0
24** **CONTINGENT LIABILITIES,0,0,0,0,0
25** **RELATED PARTY TRANSACTIONS AND ULTIMATE CONTROLLING PARTY,0,0,0,0,0
EXPLANATORY NOTE REGARDING FINANCIAL DATA,0,0,0,0,0
NO REVIEW BY THE SECURITIES AND EXCHANGE COMMISSION,0,0,0,0,0
TRADEMARKS,0,0,0,0,0
SUMMARY HISTORICAL FINANCIAL DATA OF CRASH CHAMPIONS,0,0,0,0,0
SUMMARY UNAUDITED PRO FORMA CONDENSED COMBINED FINANCIAL INFORMATION,0,0,0,0,0
NOTES TO UNAUDITED PRO FORMA CONDENSED COMBINED FINANCIAL INFORMATION,0,0,0,0,0
MANAGEMENT’S DISCUSSION AND ANALYSIS OF FINANCIAL CONDITION AND RESULTS OF OPERATIONS OF CRASH CHAMPIONS,0,0,0,0,0
MANAGEMENT’S DISCUSSION AND ANALYSIS OF FINANCIAL CONDITION AND RESULTS OF OPERATIONS OF SERVICE KING,0,0,0,0,0
LIABILITIES AND MEMBERS� EQUITY:,0,0,0,0,0
LIABILITIES AND MEMBER'S EQUITY (DEFICIT),0,0,0,0,0
CERTAIN RELATIONS AND RELATED PARTY TRANSACTIONS,0,0,0,0,0
CERTAIN U. S. FEDERAL INCOME TAX CONSIDERATIONS,0,0,0,0,0
"NEITHER THE SECURITIES AND EXCHANGE COMMISSION (THE “SEC”), ANY STATE SECURITIES COMMISSION NOR ANY OTHER REGULATORY AUTHORITY, HAS APPROVED OR DISAPPROVED OF THESE SECURITIES NOR HAVE ANY OF THE FOREGOING AUTHORITIES PASSED UPON OR ENDORSED THE MERITS OF THIS OFFERING OR THE ACCURACY OR ADEQUACY OF THIS OFFERING MEMORANDUM. ANY REPRESENTATION TO THE CONTRARY IS A CRIMINAL OFFENSE.",0,0,0,0,0
BASIS OF PRESENTATION,0,0,0,0,0
NON-U.S. GAAP FINANCIAL MEASURES,0,0,0,0,0
SUMMARY HISTORICAL AND PRO FORMA CONDENSED CONSOLIDATED FINANCIAL INFORMATION OF NOVELIS,0,0,0,0,0
CERTAIN TAX CONSIDERATIONS CERTAIN FEDERAL REPUBLIC OF GERMANY TAX CONSIDERATIONS,0,0,0,0,0
CERTAIN INSOLVENCY CONSIDERATIONS AND LIMITATIONS ON THE VALIDITY AND ENFORCEABILITY OF THE GUARANTEES,0,0,0,0,0
"O F F E R I N G M E M O R A N D U M , 2021",0,0,0,0,0
CONFIDENTIAL,0,0,0,0,0
NO SEC REVIEW,0,0,0,0,0
SUMMARY UNAUDITED PRO FORMA CONDENSED COMBINED FINANCIAL INFORMATION AND OTHER DATA,0,0,0,0,0
SUMMARY HISTORICAL CONSOLIDATED FINANCIAL AND OTHER DATA OF RITCHIE BROS.,0,0,0,0,0
CERTAIN RELATIONSHIPS AND RELATED PERSON TRANSACTIONS,0,0,0,0,0
CERTAIN ERISA AND RELATED CONSIDERATIONS,0,0,0,0,0
U.S. FEDERAL INCOME TAX CONSIDERATIONS FOR NON-U.S. HOLDERS,0,0,0,0,0
NOTICE REGARDING CANADIAN SECURITIES LAW MATTERS,0,0,0,0,0
RESPONSIBILITY STATEMENT,0,0,0,0,0
CERTAIN DEFINED TERMS,0,0,0,0,0
ALTERNATIVE PERFORMANCE MEASURES,0,0,0,0,0
BUSINESS OF THE ZF GROUP BUSINESS OVERVIEW,0,0,0,0,0
ZF DIVISIONS,0,0,0,0,0
RESEARCH AND DEVELOPMENT,0,0,0,0,0
RAW MATERIALS AND SUPPLIERS,0,0,0,0,0
COMPETITION,0,0,0,0,0
EMPLOYEES,0,0,0,0,0
LEGAL AND ARBITRATION PROCEEDINGS,0,0,0,0,0
MATERIAL CONTRACTS,0,0,0,0,0
RECENT EVENTS,0,0,0,0,0
GARANTIE]),0,0,0,0,0
§ 3 (INTEREST),0,0,0,0,0
§ 3 (ZINSEN),0,0,0,0,0
§ 4 (PAYMENTS),0,0,0,0,0
§ 4 (ZAHLUNGEN),0,0,0,0,0
§ 5 (REDEMPTION; PURCHASE AND CANCELLATION),0,0,0,0,0
§ 5 (RÜCKZAHLUNG; ANKAUF UND ENTWERTUNG),0,0,0,0,0
"§ 6 (THE FISCAL AGENT[,] [AND] THE PAYING AGENT [AND THE CALCULATION AGENT])",0,0,0,0,0
"§ 6 (DIE EMISSIONSSTELLE[,] [UND] DIE ZAHLSTELLE [UND DIE BERECHNUNGSSTELLE])",0,0,0,0,0
§ 8 (PRESENTATION PERIOD),0,0,0,0,0
§ 9 (EVENTS OF DEFAULT),0,0,0,0,0
§ 8 (VORLEGUNGSFRIST),0,0,0,0,0
§ 9 (KÜNDIGUNG),0,0,0,0,0
§ 10 (SUBSTITUTION),0,0,0,0,0
§ 10 (ERSETZUNG),0,0,0,0,0
§ 11 (FURTHER ISSUES),0,0,0,0,0
§ 11 (BEGEBUNG WEITERER SCHULDVERSCHREIBUNGEN),0,0,0,0,0
GUARANTEE],0,0,0,0,0
DER GARANTIE],0,0,0,0,0
GUARANTEE]),0,0,0,0,0
"§ 6 (DIE EMISSIONSSTELLE, DIE ZAHLSTELLE UND DIE BERECHNUNGSSTELLE)",0,0,0,0,0
§ 15 (FINAL PROVISIONS),0,0,0,0,0
§ 15 (SCHLUSSBESTIMMUNGEN),0,0,0,0,0
FINAL TERMS,0,0,0,0,0
"CURRENCY, DENOMINATION, FORM (§ 1)",0,0,0,0,0
INTEREST (§ 3),0,0,0,0,0
PAYMENTS (§ 4),0,0,0,0,0
REDEMPTION (§ 5),0,0,0,0,0
NOTICES (§ 12),0,0,0,0,0
LANGUAGE (§ 15),0,0,0,0,0
§ 2 NEGATIVVERPFLICHTUNG,0,0,0,0,0
§ 3 BESTEUERUNG,0,0,0,0,0
§ 4 BESCHLÜSSE DER GLÄUBIGER — ÄNDERUNGEN DER GARANTIE,0,0,0,0,0
§ 5 INFORMATIONEN,0,0,0,0,0
§ 6 DEFINITIONEN,0,0,0,0,0
"§ 7 ANWENDBARES RECHT, GERICHTSSTAND, SPRACHE UND GERICHTLICHE GELTENDMACHUNG",0,0,0,0,0
§ 2 NEGATIVE PLEDGE,0,0,0,0,0
§ 3 TAXATION,0,0,0,0,0
§ 4 RESOLUTIONS OF HOLDERS – AMENDMENTS TO THE GUARANTEE,0,0,0,0,0
§ 5 INFORMATION,0,0,0,0,0
§ 6 DEFINITIONS,0,0,0,0,0
"§ 7 APPLICABLE LAW, PLACE OF JURISDICTION, LANGUAGE AND ENFORCEMENT",0,0,0,0,0
ZF FRIEDRICHSHAFEN AG,0,0,0,0,0
"TAXATION WARNING THE TAX LEGISLATION OF THE STATE OF RESIDENCE OF A PROSPECTIVE PURCHASER OF NOTES OR OF A JURISDICTION WHERE A PROSPECTIVE PURCHASER IS SUBJECT TO TAXATION AND THE TAX LEGISLATION OF THE ISSUER'S AND/OR THE GUARANTOR'S COUNTRY OF INCORPORATION OR COUNTRY OF RESIDENCE MAY HAVE AN IMPACT ON THE INCOME RECEIVED FROM THE NOTES. PROSPECTIVE PURCHASERS OF NOTES ARE ADVISED TO CONSULT THEIR OWN TAX ADVISOR AS TO THE TAX CONSEQUENCES OF THE PURCHASE, OWNERSHIP AND DISPOSITION OF THE NOTES.",0,0,0,0,0
AUDITORS TO THE ISSUERS,0,0,0,0,0
RETAINED,0,0,0,0,0
SPECIALIST +** **PREMIUM** **MAINSTREAM + SUPER PREMIUM** **ENTRY PRICE,0,0,0,0,0
SUMMARY UNAUDITED PRO FORMA CONSOLIDATED FINANCIAL INFORMATION AND OTHER DATA OF THE COMBINED GROUP,0,0,0,0,0
SUMMARY HISTORICAL FINANCIAL INFORMATION AND OTHER DATA OF AGRIFARMA AND ARCAPLANET,0,0,0,0,0
SELECTED HISTORICAL FINANCIAL INFORMATION OF AGRIFARMA,0,0,0,0,0
MANAGEMENT’S DISCUSSION AND ANALYSIS OF FINANCIAL CONDITION AND RESULTS OF OPERATIONS OF AGRIFARMA,0,0,0,0,0
DAC 6,0,0,0,0,0
"THIS DISCUSSION IS FOR INFORMATIONAL PURPOSES ONLY AND IS NOT TAX ADVICE. EACH PROSPECTIVE PURCHASER SHOULD SEEK ADVICE FROM ITS OWN TAX ADVISORS ABOUT THE TAX CONSEQUENCES UNDER ITS OWN PARTICULAR CIRCUMSTANCES OF INVESTING IN NOTES UNDER THE LAWS OF ITALY, THE UNITED STATES AND ITS CONSTITUENT** **JURISDICTIONS** **AND** **ANY** **OTHER** **JURISDICTION** **WHERE** **THE PROSPECTIVE PURCHASER MAY BE SUBJECT TO TAXATION.",0,0,0,0,0
THE DISCUSSION ABOVE IS A GENERAL SUMMARY. IT DOES NOT COVER ALL TAX MATTERS THAT MAY BE OF IMPORTANCE TO A PARTICULAR INVESTOR. EACH PROSPECTIVE INVESTOR** **IS** **URGED** **TO** **CONSULT** **ITS** **OWN** **TAX** **ADVISOR** **ABOUT** **THE** **TAX CONSEQUENCES TO IT OF AN INVESTMENT IN THE NOTES IN LIGHT OF THE INVESTOR’S OWN CIRCUMSTANCES.,0,0,0,0,0
SUMMARY OF CERTAIN DIFFERENCES BETWEEN ITALIAN GAAP AND IFRS,0,0,0,0,0
"TERMINATION DATE”), WHICH IS [IN THE CASE OF REGULATION S NOTES: 40 DAYS",0,0,0,0,0
LIMITATIONS ON THE VALIDITY AND ENFORCEABILITY OF THE NOTE GUARANTEES AND THE COLLATERAL AND CERTAIN INSOLVENCY LAW CONSIDERATIONS,0,0,0,0,0
"4.** **COMMITMENTS, GUARANTEES GRANTED AND CONTINGENT LIABILTIES",0,0,0,0,0
REPORTING STANDARDS,0,0,0,0,0
CHANGES IN ACCOUNTING STANDARDS,0,0,0,0,0
CORRECTION OF SIGNIFICANT ERRORS,0,0,0,0,0
COMPARABILITY AND ADAPTATION ISSUES,0,0,0,0,0
VALUATION CRITERIA APPLIED,0,0,0,0,0
ACCRUED INCOME AND PREPAID EXPENSES,0,0,0,0,0
SHAREHOLDERS’ EQUITY,0,0,0,0,0
PROVISIONS FOR RISKS AND CHARGES,0,0,0,0,0
PAYABLES,0,0,0,0,0
ACCRUED EXPENSES AND DEFERRED INCOME,0,0,0,0,0
REVENUE OF EXCEPTIONAL EXTENT OR IMPACT,0,0,0,0,0
COSTS OF EXCEPTIONAL EXTENT OR IMPACT,0,0,0,0,0
INCOME TAX EXPENSE,0,0,0,0,0
EMPLOYEES’ SEVERANCE INDEMNITY,0,0,0,0,0
SHAREHOLDER’S EQUITY,0,0,0,0,0
CERTAIN TRADEMARKS,0,0,0,0,0
ISIN:,0,0,0,0,0
CERTAIN TERMS USED IN THIS OFFERING MEMORANDUM,0,0,0,0,0
"MARKET, RANKING AND OTHER INDUSTRY DATA",0,0,0,0,0
TRADEMARKS AND SERVICE MARKS,0,0,0,0,0
SUMMARY HISTORICAL CONDENSED CONSOLIDATED FINANCIAL INFORMATION,0,0,0,0,0
SELECTED CONSOLIDATED HISTORICAL FINANCIAL INFORMATION,0,0,0,0,0
NAME** **AGE** **POSITION,0,0,0,0,0
PRINCIPAL STOCKHOLDER,0,0,0,0,0
RELATED PERSON TRANSACTIONS,0,0,0,0,0
CERTAIN U.S. FEDERAL INCOME TAX CONSIDERATIONS FOR NON-U.S. HOLDERS,0,0,0,0,0
PRELIMINARY OFFERING MEMORANDUM** **CONFIDENTIAL NOT FOR GENERAL DISTRIBUTION IN THE UNITED STATES,0,0,0,0,0
NOTICE TO HONG KONG INVESTORS,0,0,0,0,0
NOTICE TO SINGAPORE INVESTORS,0,0,0,0,0
SERVICE OF PROCESS AND ENFORCEMENT OF FOREIGN JUDGMENTS,0,0,0,0,0
TOTAL NON CURRENT ASSETS,0,0,0,0,0
►COMPANY BACKGROUND,0,0,0,0,0
►BASIS OF PREPARATION,0,0,0,0,0
►SCOPE OF CONSOLIDATION,0,0,0,0,0
►CHANGES TO THE SCOPE OF CONSOLIDATION DURING THE FIRST THREE MONTHS OF 2024,0,0,0,0,0
►TRANSLATION OF FOREIGN CURRENCY FINANCIAL STATEMENTS,0,0,0,0,0
►USE OF ESTIMATES,0,0,0,0,0
►** **SEASONALITY,0,0,0,0,0
"►** **ACCOUNTING STANDARDS, AMENDMENTS AND INTERPRETATIONS IFRS NOT YET ENDORSED BY THE EUROPEAN UNION",0,0,0,0,0
3. COST OF SERVICES,0,0,0,0,0
5. OTHER OPERATING COSTS,0,0,0,0,0
7.MONETARY GAIN (LOSS),0,0,0,0,0
8. CONSOLIDATED STATEMENT OF CASH FLOWS,0,0,0,0,0
11. RIGHT OF USE,0,0,0,0,0
TOTAL NON CURRENT LIABILITIES** **533,0,0,0,0,0
15. NET FINANCIAL INDEBTEDNESS,0,0,0,0,0
18. TAX RECEIVABLES,0,0,0,0,0
22. PROVISIONS FOR RISKS AND CHARGES,0,0,0,0,0
24. CURRENT TAX LIABILITIES,0,0,0,0,0
FINANCIAL LIABILITIES,0,0,0,0,0
►RELATED PARTY TRANSACTIONS,0,0,0,0,0
►ACCOUNTING STANDARDS ADOPTED,0,0,0,0,0
►GOING CONCERN BASIS,0,0,0,0,0
►CONTENT OF THE CONSOLIDATED FINANCIAL STATEMENTS,0,0,0,0,0
►** **REFERENCE DATE,0,0,0,0,0
►BASIS OF CONSOLIDATION,0,0,0,0,0
►TRANSLATION OF FOREIGN CURRENCY FINANCIAL STATEMENTS - HYPERINFLATIONARY ECONOMIES,0,0,0,0,0
►ACCOUNTING POLICIES,0,0,0,0,0
►EARNINGS PER SHARE,0,0,0,0,0
►SEGMENT INFORMATION,0,0,0,0,0
►USE OF ESTIMATES AND ASSUMPTIONS,0,0,0,0,0
►ROUNDING,0,0,0,0,0
2. OPERATING SEGMENTS,0,0,0,0,0
8.MONETARY NET GAIN (LOSS),0,0,0,0,0
10. CONSOLIDATED STATEMENT OF CASH FLOWS,0,0,0,0,0
12. INTANGIBLE ASSETS,0,0,0,0,0
13. RIGHT-OF-USE,0,0,0,0,0
TOTAL NON CURRENT ASSETS** **602,0,0,0,0,0
TOTAL NON CURRENT LIABILITIES** **266,0,0,0,0,0
TOTAL NON CURRENT ASSETS** **376,0,0,0,0,0
TOTAL NON CURRENT LIABILITIES** **526,0,0,0,0,0
TOTAL NON CURRENT ASSETS** **215,0,0,0,0,0
TOTAL NON CURRENT LIABILITIES** **604,0,0,0,0,0
TOTAL NON CURRENT ASSETS** **224,0,0,0,0,0
TOTAL NON CURRENT LIABILITIES** **586,0,0,0,0,0
TOTAL NON CURRENT ASSETS** **199,0,0,0,0,0
TOTAL NON CURRENT LIABILITIES** **893,0,0,0,0,0
TOTAL NON CURRENT LIABILITIES** **246,0,0,0,0,0
"TOTAL NON CURRENT ASSETS** **24,530",0,0,0,0,0
"TOTAL NON CURRENT LIABILITIES** **8,486",0,0,0,0,0
TOTAL NON CURRENT ASSETS** **518,0,0,0,0,0
TOTAL NON CURRENT LIABILITIES** **304,0,0,0,0,0
TOTAL NON CURRENT ASSETS** **867,0,0,0,0,0
TOTAL NON CURRENT LIABILITIES** **429,0,0,0,0,0
"TOTAL NON CURRENT ASSETS** **2,527",0,0,0,0,0
"TOTAL NON CURRENT LIABILITIES** **1,101",0,0,0,0,0
"TOTAL NON CURRENT ASSETS** **8,694",0,0,0,0,0
"TOTAL NON CURRENT LIABILITIES** **4,915",0,0,0,0,0
TOTAL NON CURRENT ASSETS** **694,0,0,0,0,0
"TOTAL NON CURRENT LIABILITIES** **1,038",0,0,0,0,0
"TOTAL NON CURRENT ASSETS** **5,058",0,0,0,0,0
"TOTAL NON CURRENT LIABILITIES** **2,117",0,0,0,0,0
TOTAL NON CURRENT ASSETS** **536,0,0,0,0,0
TOTAL NON CURRENT LIABILITIES** **86,0,0,0,0,0
TOTAL NON CURRENT ASSETS** **4,0,0,0,0,0
TOTAL NON CURRENT ASSETS** **550,0,0,0,0,0
"TOTAL NON CURRENT ASSETS** **3,303",0,0,0,0,0
TOTAL NON CURRENT LIABILITIES** **216,0,0,0,0,0
"TOTAL NON CURRENT ASSETS** **22,365",0,0,0,0,0
"TOTAL CURRENT ASSETS** **14,406",0,0,0,0,0
"TOTAL NON CURRENT LIABILITIES** **7,981",0,0,0,0,0
"TOTAL CURRENT LIABILITIES** **25,549",0,0,0,0,0
TOTAL NON CURRENT ASSETS** **11,0,0,0,0,0
"TOTAL NON CURRENT ASSETS** **130,420",0,0,0,0,0
"TOTAL NON CURRENT LIABILITIES** **29,488",0,0,0,0,0
TOTAL NON CURRENT ASSETS** **10,0,0,0,0,0
TOTAL NON CURRENT LIABILITIES** **19,0,0,0,0,0
TOTAL NON CURRENT ASSETS** **7,0,0,0,0,0
TOTAL NON CURRENT LIABILITIES** **125,0,0,0,0,0
TOTAL NON CURRENT ASSETS** **1,0,0,0,0,0
TOTAL NON CURRENT LIABILITIES** **81,0,0,0,0,0
TOTAL NON CURRENT ASSETS** **123,0,0,0,0,0
TOTAL NON CURRENT LIABILITIES** **106,0,0,0,0,0
TOTAL NON CURRENT LIABILITIES** **71,0,0,0,0,0
TOTAL NON CURRENT ASSETS** **20,0,0,0,0,0
TOTAL NON CURRENT LIABILITIES** **974,0,0,0,0,0
TOTAL NON CURRENT ASSETS** **26,0,0,0,0,0
TOTAL NON CURRENT LIABILITIES** **144,0,0,0,0,0
TOTAL NON CURRENT LIABILITIES** **30,0,0,0,0,0
TOTAL NON CURRENT ASSETS** **8,0,0,0,0,0
TOTAL NON CURRENT LIABILITIES** **16,0,0,0,0,0
16. INVESTMENTS IN OTHER COMPANIES AND INVESTMENTS IN ASSOCIATES,0,0,0,0,0
32. INDEPENDENT AUDITORS,0,0,0,0,0
FIN-MD-TECH,0,0,0,0,0
► REFERENCE DATE,0,0,0,0,0
"ACCOUNTING STANDARDS, AMENDMENTS AND IFRS INTERPRETATIONS NOT YET ENDORSED BY THE EUROPEAN UNION",0,0,0,0,0
8. FINANCE COSTS,0,0,0,0,0
"TOTAL NON CURRENT LIABILITIES** **11,581",0,0,0,0,0
"TOTAL NON CURRENT ASSETS** **4,904",0,0,0,0,0
"TOTAL NON CURRENT LIABILITIES** **2,969",0,0,0,0,0
"TOTAL NON CURRENT ASSETS** **3,577",0,0,0,0,0
"TOTAL NON CURRENT LIABILITIES** **1,485",0,0,0,0,0
TOTAL NON CURRENT LIABILITIES** **109,0,0,0,0,0
"TOTAL NON CURRENT ASSETS** **1,726",0,0,0,0,0
TOTAL NON CURRENT LIABILITIES** **398,0,0,0,0,0
TOTAL NON CURRENT ASSETS** **73,0,0,0,0,0
TOTAL NON CURRENT LIABILITIES** **112,0,0,0,0,0
TOTAL NON CURRENT LIABILITIES** **134,0,0,0,0,0
TOTAL NON CURRENT ASSETS** **742,0,0,0,0,0
TOTAL NON CURRENT LIABILITIES** **167,0,0,0,0,0
TOTAL NON CURRENT ASSETS** **35,0,0,0,0,0
TOTAL NON CURRENT ASSETS** **60,0,0,0,0,0
TOTAL NON CURRENT LIABILITIES** **531,0,0,0,0,0
TOTAL NON CURRENT ASSETS** **95,0,0,0,0,0
TOTAL NON CURRENT LIABILITIES** **618,0,0,0,0,0
TOTAL NON CURRENT ASSETS** **34,0,0,0,0,0
TOTAL NON CURRENT LIABILITIES** **601,0,0,0,0,0
TOTAL NON CURRENT ASSETS** **65,0,0,0,0,0
TOTAL NON CURRENT LIABILITIES** **922,0,0,0,0,0
THE REFINANCING AND CERTAIN RELATED TRANSACTIONS,0,0,0,0,0
OVERVIEW OF OUR CORPORATE AND FINANCING STRUCTURE,0,0,0,0,0
SELECTED FINANCIAL AND OTHER INFORMATION,0,0,0,0,0
OFF-BALANCE SHEET ARRANGEMENTS,0,0,0,0,0
SALES AND MARKETING,0,0,0,0,0
LEGAL PROCEEDINGS,0,0,0,0,0
AMENDED AND RESTATED SENIOR SECURED PLN FACILITIES,0,0,0,0,0
SENIOR SECURED GBP FACILITY,0,0,0,0,0
EXISTING NOTES,0,0,0,0,0
CZECH REPUBLIC,0,0,0,0,0
ACTION BY OWNERS OF BOOK-ENTRY INTERESTS,0,0,0,0,0
B.** **SIGNIFICANT BUSINESS TRANSACTIONS,0,0,0,0,0
C.** **BASIS OF CONSOLIDATION,0,0,0,0,0
PRIIPS REGULATION/PROHIBITION OF SALES TO EEA RETAIL INVESTORS,0,0,0,0,0
U.K. PRIIPS REGULATION/PROHIBITION OF SALES TO U.K. RETAIL INVESTORS,0,0,0,0,0
MIFID II PRODUCT GOVERNANCE/PROFESSIONAL INVESTORS AND ECPS ONLY TARGET MARKET,0,0,0,0,0
U.K. MIFIR PRODUCT GOVERNANCE / PROFESSIONAL INVESTORS AND ECPS ONLY TARGET MARKET,0,0,0,0,0
NOTICE TO EEA AND U.K. INVESTORS,0,0,0,0,0
NOTICE TO INVESTORS IN THE U.K.,0,0,0,0,0
NOTICE TO ISRAELI INVESTORS,0,0,0,0,0
PRESENTATION OF FINANCIAL AND OTHER INFORMATION,0,0,0,0,0
GENERAL DESCRIPTION OF OUR BUSINESS AND THE OFFERING,0,0,0,0,0
MANAGEMENT’S DISCUSSION AND ANALYSIS OF FINANCIAL CONDITION AND RESULTS OF OPERATIONS OF THE GROUP,0,0,0,0,0
LIMITATION ON VALIDITY AND ENFORCEABILITY OF THE GUARANTEES AND THE SECURITY INTERESTS,0,0,0,0,0
CUSIP** **ISIN,0,0,0,0,0
LEGAL ADVISERS TO THE ISSUER,0,0,0,0,0
INDEX TO FINANCIAL STATEMENTS ALTICE INTERNATIONAL S.À R.L.,0,0,0,0,0
NO REVIEW BY SEC,0,0,0,0,0
CERTAIN UNITED STATES FEDERAL TAX CONSEQUENCES,0,0,0,0,0
ACKNOWLEDGEMENT OF INDEPENDENT REGISTERED PUBLIC ACCOUNTING FIRM,0,0,0,0,0
AVAILABLE INFORMATION AND INCORPORATION BY REFERENCE,0,0,0,0,0
PRELIMINARY OFFERING MEMORANDUM                                            CONFIDENTIAL,0,0,0,0,0
NO REVIEW BY THE SEC; NO REGISTRATION,0,0,0,0,0
INDUSTRY AND OTHER STATISTICAL DATA,0,0,0,0,0
DOCUMENTS INCORPORATED BY REFERENCE; WHERE YOU CAN FIND MORE INFORMATION,0,0,0,0,0
USE OF NON-GAAP FINANCIAL INFORMATION,0,0,0,0,0
"PRELIMINARY OFFERING MEMORANDUM , 2024",0,0,0,0,0
OFFERING MEMORANDUM** **CONFIDENTIAL,0,0,0,0,0
ABOUT THIS OFFERING MEMORANDUM,0,0,0,0,0
PRESENTATION OF FINANCIAL INFORMATION - AKUMIN,0,0,0,0,0
PRESENTATION OF FINANCIAL INFORMATION - ALLIANCE,0,0,0,0,0
NON-GAAP MEASURES - AKUMIN,0,0,0,0,0
NON-GAAP INFORMATION - ALLIANCE,0,0,0,0,0
INTERNET INFORMATION,0,0,0,0,0
SUMMARY HISTORICAL CONSOLIDATED FINANCIAL INFORMATION AND OTHER DATA - ALLIANCE,0,0,0,0,0
DIRECTORS AND MANAGEMENT,0,0,0,0,0
TRANSFER RESTRICTIONS AND CERTAIN NOTICES TO INVESTORS,0,0,0,0,0
OUR INVESTOR,0,0,0,0,0
NOTICE TO JERSEY INVESTORS,0,0,0,0,0
NOTICE TO LUXEMBOURG RESIDENTS,0,0,0,0,0
NOTICE TO DUTCH INVESTORS,0,0,0,0,0
NOTICE TO ITALIAN INVESTORS,0,0,0,0,0
NOTICE TO SPANISH INVESTORS,0,0,0,0,0
NOTICE TO FRENCH INVESTORS,0,0,0,0,0
NOTICE TO AUSTRIAN INVESTORS,0,0,0,0,0
HISTORICAL AND CURRENT MARKET AND INDUSTRY DATA,0,0,0,0,0
TRADE MARKS AND TRADE NAMES,0,0,0,0,0
CURRENCY PRESENTATION AND EXCHANGE RATES,0,0,0,0,0
BUSINESS STRATEGY,0,0,0,0,0
SUMMARY HISTORICAL CONSOLIDATED FINANCIAL INFORMATION AND OTHER FINANCIAL DATA,0,0,0,0,0
CAPITALISATION,0,0,0,0,0
OUR BUSINESSES,0,0,0,0,0
OUR CUSTOMERS,0,0,0,0,0
OUR BRANDS,0,0,0,0,0
OUR STORE FORMATS,0,0,0,0,0
OUR TENANTS AND STRATEGIC PARTNERS,0,0,0,0,0
OUR COLLEAGUES,0,0,0,0,0
OUR SUPPLIERS AND LOGISTICS,0,0,0,0,0
OUR TECHNOLOGY AND INFORMATION SYSTEMS,0,0,0,0,0
"OUR PUBLICITY,** **MARKETING AND CUSTOMER SERVICE",0,0,0,0,0
OUR INTELLECTUAL PROPERTY,0,0,0,0,0
CERTAIN INSOLVENCY CONSIDERATIONS AND LIMITATIONS ON VALIDITY AND ENFORCEABILITY OF THE NOTES GUARANTEES AND THE SECURITY INTERESTS,0,0,0,0,0
INDEPENDENT AUDITOR'S REPORT TO THE MEMBERS OF ASDA GROUP LIMITED (CONTINUED),0,0,0,0,0
REGISTRAR AND TRANSFER AGENTS** **ESCROW AGENT,0,0,0,0,0
NOTICE TO BELGIAN INVESTORS,0,0,0,0,0
VALUATION REPORT,0,0,0,0,0
THE SENIOR SECURED NOTES ISSUER,0,0,0,0,0
KPMG LLP,0,0,0,0,0
"THIS OFFERING MEMORANDUM CONTAINS IMPORTANT INFORMATION, WHICH YOU SHOULD READ BEFORE YOU MAKE ANY DECISION WITH RESPECT TO AN INVESTMENT IN THE SENIOR SECURED NOTES.",0,0,0,0,0
SUMMARY HISTORICAL AND OTHER FINANCIAL INFORMATION,0,0,0,0,0
SELECTED HISTORICAL FINANCIAL AND OTHER INFORMATION,0,0,0,0,0
LIMITATIONS ON VALIDITY AND ENFORCEMENT OF THE GUARANTEES AND THE COLLATERAL AND CERTAIN INSOLVENCY LAW CONSIDERATIONS,0,0,0,0,0
LEGAL ADVISORS TO THE ISSUER AND THE COMPANY,0,0,0,0,0
LEGAL ADVISORS TO THE INITIAL PURCHASERS AND THE SECURITY AGENT,0,0,0,0,0
U.S.A.,0,0,0,0,0
U.K.,0,0,0,0,0
NOTICE TO INVESTORS NOTICE TO U.S. INVESTORS,0,0,0,0,0
NOTICE TO INVESTORS IN GERMANY,0,0,0,0,0
NOTICE TO INVESTORS IN THE NETHERLANDS,0,0,0,0,0
INDEPENDENT REPORTING ACCOUNTANTS,0,0,0,0,0
COMBINED CARVE-OUT FINANCIAL STATEMENTS OF THE SPREADS BUSINESS OF UNILEVER PLC AND UNILEVER NV,0,0,0,0,0
COMBINED CARVE-OUT INCOME STATEMENT,0,0,0,0,0
COMBINED CARVE-OUT STATEMENT OF COMPREHENSIVE INCOME,0,0,0,0,0
COMBINED CARVE-OUT BALANCE SHEET,0,0,0,0,0
COMBINED CARVE-OUT CASH FLOW STATEMENT,0,0,0,0,0
THE SPREADS BUSINESS,0,0,0,0,0
BASIS OF COMBINATION,0,0,0,0,0
ACCOUNTING POLICIES,0,0,0,0,0
CRITICAL ACCOUNTING ESTIMATES AND JUDGEMENTS,0,0,0,0,0
"1. BASIS OF PREPARATION AND ACCOUNTING POLICIES, ESTIMATES, JUDGEMENTS AND ASSUMPTIONS RECENT ACCOUNTING DEVELOPMENTS ADOPTED BY THE SPREADS BUSINESS",0,0,0,0,0
"NEW STANDARDS, AMENDMENTS AND INTERPRETATIONS OF EXISTING STANDARDS THAT ARE NOT YET EFFECTIVE AND HAVE NOT BEEN EARLY ADOPTED BY THE SPREADS BUSINESS",0,0,0,0,0
UNDERLYING OPERATING PROFIT,0,0,0,0,0
3. OPERATING COSTS AND NON-UNDERLYING ITEMS BRAND AND MARKETING INVESTMENT,0,0,0,0,0
NON-UNDERLYING ITEMS,0,0,0,0,0
GROSS PROFIT AND OPERATING COSTS,0,0,0,0,0
4. EMPLOYEES,0,0,0,0,0
DESCRIPTION OF PLANS – DEFINED CONTRIBUTION,0,0,0,0,0
DESCRIPTION OF PLANS – DEFINED BENEFIT,0,0,0,0,0
ASSUMPTIONS,0,0,0,0,0
STATEMENT OF COMPREHENSIVE INCOME,0,0,0,0,0
CASH FLOW,0,0,0,0,0
PERFORMANCE SHARE PLANS,0,0,0,0,0
5. NET FINANCE COSTS,0,0,0,0,0
6. TAXATION,0,0,0,0,0
7. INTANGIBLE ASSETS INTANGIBLE ASSETS,0,0,0,0,0
IMPAIRMENT CHARGES,0,0,0,0,0
"8. PROPERTY, PLANT AND EQUIPMENT",0,0,0,0,0
9. OTHER NON-CURRENT ASSETS,0,0,0,0,0
10. INVENTORIES,0,0,0,0,0
11. TRADE AND OTHER CURRENT RECEIVABLES,0,0,0,0,0
12. TRADE PAYABLES AND OTHER LIABILITIES,0,0,0,0,0
13. CAPITAL AND FUNDING NET PARENT (DEFICIT) / INVESTMENT,0,0,0,0,0
SHARE-BASED COMPENSATION,0,0,0,0,0
DERIVATIVE FINANCIAL INSTRUMENTS,0,0,0,0,0
SUBSIDIARIES WITH NON-CONTROLLING INTERESTS,0,0,0,0,0
DIVIDENDS,0,0,0,0,0
RECONCILIATION OF LIABILITIES ARISING FROM FINANCING ACTIVITIES:,0,0,0,0,0
14. TREASURY RISK MANAGEMENT DERIVATIVES AND HEDGE ACCOUNTING,0,0,0,0,0
(II) DERIVATIVES FOR WHICH HEDGE ACCOUNTING IS NOT APPLIED,0,0,0,0,0
MANAGEMENT POLICY AND POTENTIAL IMPACT OF RISK** **HEDGING STRATEGY** **SENSITIVITY TO THE RISK (I) COMMODITY PRICE RISK,0,0,0,0,0
15. INVESTMENT AND RETURN CASH AND CASH EQUIVALENTS,0,0,0,0,0
16. FINANCIAL INSTRUMENTS FAIR VALUE RISK,0,0,0,0,0
17. PROVISIONS,0,0,0,0,0
18. COMMITMENTS AND CONTINGENT LIABILITIES,0,0,0,0,0
CONTINGENT LIABILITIES,0,0,0,0,0
19. RELATED PARTY TRANSACTIONS,0,0,0,0,0
LOAN BALANCES PAYABLE TO UNILEVER,0,0,0,0,0
20. BRANDS / PRODUCTS,0,0,0,0,0
21. LEGAL ENTITIES,0,0,0,0,0
22. EVENTS AFTER THE BALANCE SHEET DATE,0,0,0,0,0
INDEPENDENT REPORTING ACCOUNTANTS KPMG LLP,0,0,0,0,0
REGULATION OVERVIEW,0,0,0,0,0
LIMITATIONS ON VALIDITY AND ENFORCEABILITY OF THE GUARANTEES AND THE SECURITY INTERESTS,0,0,0,0,0
PRELIMINARY OFFERING MEMORANDUM** **NOT FOR GENERAL DISTRIBUTION STRICTLY CONFIDENTIAL** **IN THE UNITED STATES,0,0,0,0,0
KIRKBI,0,0,0,0,0
CERTAIN INSOLVENCY LAW CONSIDERATIONS AND LIMITATIONS ON THE VALIDITY AND ENFORCEABILITY OF THE GUARANTEES AND SECURITY,0,0,0,0,0
1.1** **BASIS OF PREPARATION,0,0,0,0,0
2.3** **TAXATION,0,0,0,0,0
"3.1** **PROPERTY, PLANT AND EQUIPMENT",0,0,0,0,0
3.2** **RIGHT-OF-USE ASSETS,0,0,0,0,0
3.3** **GOODWILL AND INTANGIBLE ASSETS,0,0,0,0,0
4.1** **NET DEBT,0,0,0,0,0
4.1** **NET DEBT (CONTINUED),0,0,0,0,0
1.1** **BASIS OF PREPARATION (CONTINUED),0,0,0,0,0
2.1** **PROFIT BEFORE TAX (CONTINUED),0,0,0,0,0
2.4** **TAXATION (CONTINUED),0,0,0,0,0
4.2** **GOODWILL AND INTANGIBLE ASSETS (CONTINUED),0,0,0,0,0
4.3** **IMPAIRMENT TESTING (CONTINUED),0,0,0,0,0
4.4** **WORKING CAPITAL (CONTINUED),0,0,0,0,0
5.2** **INTEREST-BEARING LOANS AND BORROWINGS (CONTINUED),0,0,0,0,0
5.3** **FINANCIAL RISK MANAGEMENT (CONTINUED),0,0,0,0,0
5.4** **LEASE OBLIGATIONS (CONTINUED),0,0,0,0,0
5.5** **EQUITY AND CAPITAL MANAGEMENT (CONTINUED),0,0,0,0,0
5.6** **SHARE-BASED PAYMENT TRANSACTIONS (CONTINUED),0,0,0,0,0
6.1** **INVESTMENTS (CONTINUED),0,0,0,0,0
6.2** **EMPLOYEE BENEFITS (CONTINUED),0,0,0,0,0
6.3** **RELATED PARTY TRANSACTIONS (CONTINUED),0,0,0,0,0
6.4** **NEW STANDARDS AND INTERPRETATIONS,0,0,0,0,0
6.5** **ULTIMATE PARENT COMPANY INFORMATION,0,0,0,0,0
6.6** **SUBSIDIARY AND JOINT VENTURE UNDERTAKINGS,0,0,0,0,0
6.6** **SUBSIDIARY AND JOINT VENTURE UNDERTAKINGS (CONTINUED),0,0,0,0,0
3.2** **GOODWILL AND INTANGIBLE ASSETS (CONTINUED),0,0,0,0,0
3.3** **IMPAIRMENT TESTING (CONTINUED),0,0,0,0,0
3.4** **WORKING CAPITAL (CONTINUED),0,0,0,0,0
4.2** **INTEREST-BEARING LOANS AND BORROWINGS (CONTINUED),0,0,0,0,0
4.3** **FINANCIAL RISK MANAGEMENT (CONTINUED),0,0,0,0,0
4.4** **LEASE OBLIGATIONS (CONTINUED),0,0,0,0,0
4.5** **EQUITY AND CAPITAL MANAGEMENT (CONTINUED),0,0,0,0,0
4.6** **SHARE-BASED PAYMENT TRANSACTIONS (CONTINUED),0,0,0,0,0
5.2** **EMPLOYEE BENEFITS (CONTINUED),0,0,0,0,0
5.3** **RELATED PARTY TRANSACTIONS (CONTINUED),0,0,0,0,0
5.4** **NEW STANDARDS AND INTERPRETATIONS,0,0,0,0,0
5.5** **ULTIMATE PARENT COMPANY INFORMATION,0,0,0,0,0
5.7** **SUBSIDIARY AND JOINT VENTURE UNDERTAKINGS,0,0,0,0,0
5.7** **SUBSIDIARY AND JOINT VENTURE UNDERTAKINGS (CONTINUED),0,0,0,0,0
"CALENDAR DAYS AFTER THE DATE OF THE ALLOTMENT OF THE NOTES. ANY STABILISATION ACTION OR OVER-ALLOTMENT MUST BE CONDUCTED BY THE STABILISATION MANAGER (OR PERSONS ACTING ON THE STABILISATION MANAGER’S BEHALF) IN ACCORDANCE WITH ALL APPLICABLE LAWS AND RULES. FOR A DESCRIPTION OF THESE ACTIVITIES, SEE ‘‘PLAN OF",0,0,0,0,0
2.2** **EXCEPTIONAL ITEMS (CONTINUED),0,0,0,0,0
2.5** **DISCONTINUED OPERATIONS,0,0,0,0,0
5.4** **CONTINGENT LIABILITIES,0,0,0,0,0
5.5** **NEW STANDARDS AND INTERPRETATIONS,0,0,0,0,0
5.6** **ULTIMATE PARENT COMPANY INFORMATION,0,0,0,0,0
5.7** **SUBSEQUENT EVENTS,0,0,0,0,0
5.8** **SUBSIDIARY AND JOINT VENTURE UNDERTAKINGS,0,0,0,0,0
5.8** **SUBSIDIARY AND JOINT VENTURE UNDERTAKINGS (CONTINUED),0,0,0,0,0
1.1 BASIS OF PREPARATION,0,0,0,0,0
1.1 BASIS OF PREPARATION (CONTINUED),0,0,0,0,0
2.1 PROFIT BEFORE TAX (CONTINUED),0,0,0,0,0
2.4 TAXATION (CONTINUED),0,0,0,0,0
3.2 GOODWILL AND INTANGIBLE ASSETS (CONTINUED),0,0,0,0,0
4.2 INTEREST-BEARING LOANS AND BORROWINGS (CONTINUED),0,0,0,0,0
4.3 FINANCIAL RISK MANAGEMENT (CONTINUED),0,0,0,0,0
4.4 LEASE OBLIGATIONS (CONTINUED),0,0,0,0,0
4.5 EQUITY AND CAPITAL MANAGEMENT (CONTINUED),0,0,0,0,0
4.6 SHARE-BASED PAYMENT TRANSACTIONS (CONTINUED),0,0,0,0,0
5.2 EMPLOYEE BENEFITS (CONTINUED),0,0,0,0,0
5.4 CONTINGENT LIABILITIES,0,0,0,0,0
5.5 NEW STANDARDS AND INTERPRETATIONS,0,0,0,0,0
IFRS 16,0,0,0,0,0
5.5 NEW STANDARDS AND INTERPRETATIONS (CONTINUED),0,0,0,0,0
5.6 ULTIMATE PARENT COMPANY INFORMATION,0,0,0,0,0
5.7 SUBSEQUENT EVENTS,0,0,0,0,0
5.8 SUBSIDIARY AND JOINT VENTURE UNDERTAKINGS,0,0,0,0,0
5.8 SUBSIDIARY AND JOINT VENTURE UNDERTAKINGS (CONTINUED),0,0,0,0,0
TO THE MEMBERS OF MERLIN ENTERTAINMENTS PLC,0,0,0,0,0
PRIMARY STATEMENTS,0,0,0,0,0
NOTES TO THE ACCOUNTS,0,0,0,0,0
MERLIN ENTERTAINMENTS PLC,0,0,0,0,0
NOTES TO MERLIN ENTERTAINMENTS PLC,0,0,0,0,0
INDEPENDENT AUDITORS OF MEL KPMG LLP,0,0,0,0,0
"SUMMARY HISTORICAL FINANCIAL INFORMATION, UNAUDITED ADJUSTED FINANCIAL INFORMATION FOR THE ONGOING BUSINESS AND OTHER FINANCIAL DATA",0,0,0,0,0
UNAUDITED ADJUSTED FINANCIAL INFORMATION FOR THE ONGOING BUSINESS,0,0,0,0,0
CURRENCY PRESENTATION AND EXCHANGE RATE DATA,0,0,0,0,0
SUMMARY HISTORICAL CONSOLIDATED AND PRO FORMA CONDENSED CONSOLIDATED FINANCIAL AND OPERATIONAL DATA,0,0,0,0,0
UNAUDITED PRO FORMA CONDENSED CONSOLIDATED FINANCIAL INFORMATION,0,0,0,0,0
LIABILITIES AND STOCKHOLDERS’ EQUITY (DEFICIT),0,0,0,0,0
REGULATION”) OR ANY IMPLEMENTING LEGISLATION OR RULES RELATING THERETO. THIS,0,0,0,0,0
NOTICE TO EU INVESTORS,0,0,0,0,0
PRIIPS REGULATION/PROHIBITION OF SALES TO EEA RETAIL INVESTORS:,0,0,0,0,0
THIS** **OFFERING** **MEMORANDUM** **AND** **THE** **INFORMATION** **INCORPORATED** **BY REFERENCE HEREIN CONTAIN IMPORTANT INFORMATION THAT YOU SHOULD READ BEFORE YOU MAKE ANY DECISION WITH RESPECT TO AN INVESTMENT IN THE NOTES. DOCUMENTS INCORPORATED BY REFERENCE,0,0,0,0,0
SUMMARY FINANCIAL AND OPERATING DATA,0,0,0,0,0
SUMMARY OF THE NOTES,0,0,0,0,0
SUSTAINABILITY-LINKED FINANCE FRAMEWORK,0,0,0,0,0
"DESCRIPTION OF THE COLLATERAL SHARING AGREEMENT, THE FINCO FACILITIES ACCESSION AGREEMENTS AND THE RELATED AGREEMENTS",0,0,0,0,0
SUSTAINABILITY OF VODAFONEZIGGO,0,0,0,0,0
ANNEX A EXISTING CREDIT FACILITY,0,0,0,0,0
BACKGROUND,0,0,0,0,0
2.** **AMENDMENT AND RESTATEMENT OF THE CREDIT AGREEMENT,0,0,0,0,0
4.** **GUARANTEE AND SECURITY,0,0,0,0,0
5.** **MISCELLANEOUS,0,0,0,0,0
6.** **GOVERNING LAW,0,0,0,0,0
SCHEDULE 2 AMENDED CREDIT AGREEMENT,0,0,0,0,0
22.19 ERISA,0,0,0,0,0
24.** **UNDERTAKINGS,0,0,0,0,0
24.11 ERISA,0,0,0,0,0
33.** **BREAK COSTS,0,0,0,0,0
40.** **REMEDIES AND WAIVERS,0,0,0,0,0
42.** **ENGLISH LANGUAGE,0,0,0,0,0
43.** **PARTIAL INVALIDITY,0,0,0,0,0
47.** **COUNTERPARTS,0,0,0,0,0
48.** **GOVERNING LAW,0,0,0,0,0
50.** **COMPLETE AGREEMENT,0,0,0,0,0
SCHEDULE 4 FORM OF TRANSFER DEED,0,0,0,0,0
[ACCESSION TO THE INTERCREDITOR AGREEMENT,0,0,0,0,0
THE SCHEDULE,0,0,0,0,0
ADMINISTRATIVE AND FACILITY OFFICE DETAILS,0,0,0,0,0
SCHEDULE 5 FORM OF TRANSFER AGREEMENT,0,0,0,0,0
NOW THIS DEED WITNESS AS FOLLOWS:,0,0,0,0,0
[THE SUBSIDIARY,0,0,0,0,0
) WITNESS,0,0,0,0,0
THE FACILITY AGENT,0,0,0,0,0
THE SECURITY AGENT [Š],0,0,0,0,0
SCHEDULE 7 ACCESSION DOCUMENTS,0,0,0,0,0
SCHEDULE 10 FORM OF L/C BANK ACCESSION CERTIFICATE,0,0,0,0,0
SCHEDULE 11 FORM OF DOCUMENTARY CREDIT,0,0,0,0,0
FORM OF DEMAND,0,0,0,0,0
SCHEDULE 12 FORM OF INCREASE CONFIRMATION,0,0,0,0,0
SCHEDULE 13 AGREED SECURITY PRINCIPLES,0,0,0,0,0
SCHEDULE 14 FORM OF RESIGNATION LETTER,0,0,0,0,0
SCHEDULE 17 FORM OF DESIGNATED ENTITY ACCESSION AGREEMENT,0,0,0,0,0
SCHEDULE 18 COVENANTS,0,0,0,0,0
SCHEDULE 19 EVENTS OF DEFAULT,0,0,0,0,0
SCHEDULE 20 RELEASES,0,0,0,0,0
SCHEDULE 21 DEFINITIONS,0,0,0,0,0
[SIGNATURE PAGES NOT RESTATED],0,0,0,0,0
SIGNATURES,0,0,0,0,0
ANNEX B FORM OF NEW FINCO FACILITIES DEEDS OF COVENANT,0,0,0,0,0
TABLE OF CONTENTS PAGE,0,0,0,0,0
RECITALS:,0,0,0,0,0
2.** **COVENANTS,0,0,0,0,0
3.** **COMPANY’S AND THE CREDIT FACILITY BORROWER’S LIABILITY,0,0,0,0,0
4.** **ISSUER’S LIABILITY,0,0,0,0,0
5.** **COSTS AND EXPENSES,0,0,0,0,0
6.** **ASSIGNMENT AND TRANSFER,0,0,0,0,0
7.** **NOTICES,0,0,0,0,0
8.** **GOVERNING LAW,0,0,0,0,0
9.** **JURISDICTION,0,0,0,0,0
10.** **THIRD PARTY RIGHTS,0,0,0,0,0
11.** **PARTIAL INVALIDITY,0,0,0,0,0
12.** **COUNTERPARTS,0,0,0,0,0
ANNEX C FORM OF FINCO DOLLAR FACILITY ACCESSION AGREEMENT,0,0,0,0,0
$[Š] ADDITIONAL FACILITY J ACCESSION DEED,0,0,0,0,0
SCHEDULE 2 CONDITIONS PRECEDENT DOCUMENTS,0,0,0,0,0
"SCHEDULE 3 AMENDMENTS, WAIVERS, CONSENTS AND OTHER MODIFICATIONS",0,0,0,0,0
"SCHEDULE 4 AMENDMENTS, WAIVERS, CONSENTS AND OTHER MODIFICATIONS",0,0,0,0,0
WITNESS,0,0,0,0,0
AMSTERDAMSE BEHEER- EN CONSULTINGMAATSCHAPPIJ B.V.,0,0,0,0,0
ANNEX D FORM OF FINCO EURO FACILITY ACCESSION AGREEMENT,0,0,0,0,0
€[Š] ADDITIONAL FACILITY K ACCESSION DEED,0,0,0,0,0
ANNEX E FINCO DOLLAR FACILITY FEE LETTER,0,0,0,0,0
SENIOR FACILITIES AGREEMENT — FINCO DOLLAR FEE LETTER,0,0,0,0,0
1.** **DEFINITIONS,0,0,0,0,0
2.** **FEES,0,0,0,0,0
3.** **MISCELLANEOUS,0,0,0,0,0
LENDER,0,0,0,0,0
VZ SECURED FINANCING B.V.,0,0,0,0,0
ZIGGO B.V.,0,0,0,0,0
ANNEX F FINCO EURO FACILITY FEE LETTER,0,0,0,0,0
SENIOR FACILITIES AGREEMENT — FINCO EURO FEE LETTER,0,0,0,0,0
LEGAL ADVISORS TO THE ISSUER AND VODAFONEZIGGO,0,0,0,0,0
INDEPENDENT AUDITORS FOR VODAFONEZIGGO KPMG ACCOUNTANTS N.V.,0,0,0,0,0
"MANAGER”) AND GOLDMAN SACHS INTERNATIONAL (THE “DOLLAR STABILIZING MANAGER”, AND TOGETHER WITH THE EURO STABILIZING MANAGER, THE “STABILIZING MANAGERS”) (OR PERSONS ACTING ON BEHALF OF THE STABILIZING MANAGERS), MAY OVER",0,0,0,0,0
PRIIPS REGULATION/PROHIBITION OF SALES TO EEA AND U.K. RETAIL INVESTORS,0,0,0,0,0
THIS OFFERING MEMORANDUM CONTAINS IMPORTANT INFORMATION WHICH YOU SHOULD READ BEFORE YOU MAKE ANY DECISION WITH RESPECT TO AN INVESTMENT IN THE NOTES. AVAILABLE INFORMATION,0,0,0,0,0
"INDUSTRY, COMPETITION AND MARKET OVERVIEW",0,0,0,0,0
LIMITATION ON VALIDITY AND ENFORCEABILITY OF THE NOTES GUARANTEES AND THE SECURITY INTERESTS AND INSOLVENCY LAWS OF CERTAIN JURISDICTIONS,0,0,0,0,0
33.1.2.** **SFR,0,0,0,0,0
"THE SECURITIES OFFERED HEREBY HAVE NOT BEEN RECOMMENDED BY ANY FEDERAL, STATE OR FOREIGN SECURITIES COMMISSION OR REGULATORY AUTHORITY. FURTHERMORE, THE FOREGOING AUTHORITIES HAVE NOT REVIEWED THIS DOCUMENT, CONFIRMED THE ACCURACY OR DETERMINED THE MERITS OR ADEQUACY OF THIS DOCUMENT. ANY REPRESENTATION TO THE CONTRARY IS A CRIMINAL OFFENSE.",0,0,0,0,0
WHERE YOU CAN FIND MORE INFORMATION; INFORMATION INCORPORATED BY REFERENCE,0,0,0,0,0
"YOU SHOULD CONSULT AN INDEPENDENT TAX ADVISOR REGARDING THE U.S. FEDERAL INCOME TAX CONSEQUENCES TO YOU OF ACQUIRING, OWNING AND DISPOSING OF THE NOTES, AS WELL AS THE APPLICATION OF STATE, LOCAL AND NON-U.S. INCOME AND OTHER TAX LAWS.",0,0,0,0,0
STRICTLY CONFIDENTIAL** **IN THE UNITED STATES,0,0,0,0,0
SUMMARY CONSOLIDATED HISTORICAL AND AS ADJUSTED FINANCIAL INFORMATION AND OTHER DATA,0,0,0,0,0
EQUITY ATTRIBUTABLE TO EQUITY HOLDERS OF THE COMPANY OTHER RESERVES MERGER RESERVE $M CURRENCY TRANSLATION RESERVE $M RETAINED EARNINGS $M SHARE CAPITAL $M SHARE PREMIUM ACCOUNT $M CAPITAL CONTRIBUTION RESERVE $M TOTAL EQUITY $M,0,0,0,0,0
OTHER RESERVES MERGER RESERVE $M CURRENCY TRANSLATION RESERVE $M RETAINED EARNINGS $M SHARE CAPITAL $M SHARE PREMIUM ACCOUNT $M CAPITAL CONTRIBUTION RESERVE $M TOTAL EQUITY $M,0,0,0,0,0
1. GENERAL INFORMATION AND BASIS OF PREPARATION,0,0,0,0,0
GOING CONCERN,0,0,0,0,0
1. GENERAL INFORMATION AND BASIS OF PREPARATION CONTINUED,0,0,0,0,0
MATERIAL ACCOUNTING POLICIES,0,0,0,0,0
1. GENERAL INFORMATION AND BASIS OF PREPARATION CONTINUED USE OF ESTIMATES AND JUDGEMENTS,0,0,0,0,0
"2. ADOPTION OF NEW AND REVISED STANDARDS, AMENDMENTS AND INTERPRETTIONS",0,0,0,0,0
3. EXCEPTIONAL ITEMS,0,0,0,0,0
4. REVENUE,0,0,0,0,0
CARRYING AMOUNT,0,0,0,0,0
7. GOODWILL CONTINUED,0,0,0,0,0
ACCUMULATED AMORTISATION AND IMPAIRMENT,0,0,0,0,0
"9. PROPERTY, PLANT AND EQUIPMENT LAND AND** **FIXTURES AND** **ASSETS UNDER BUILDINGS** **FITTINGS** **CONSTRUCTION** **TOTAL $M** **$M** **$M** **$M COST",0,0,0,0,0
ACCUMULATED DEPRECIATION AND IMPAIRMENT,0,0,0,0,0
LAND AND** **FIXTURES AND** **ASSETS UNDER BUILDINGS** **FITTINGS** **CONSTRUCTION** **TOTAL $M** **$M** **$M** **$M COST,0,0,0,0,0
13. BORROWINGS CONTINUED,0,0,0,0,0
17. POST BALANCE SHEET EVENTS CONTINUED,0,0,0,0,0
18. RELATED PARTY TRANSACTIONS,0,0,0,0,0
18. RELATED PARTY TRANSACTIONS CONTINUED,0,0,0,0,0
OPINION,0,0,0,0,0
"2. ADOPTION OF NEW AND REVISED STANDARDS, AMENDMENTS AND INTERPRETATIONS",0,0,0,0,0
3. SIGNIFICANT ACCOUNTING POLICIES,0,0,0,0,0
3. SIGNIFICANT ACCOUNTING POLICIES CONTINUED,0,0,0,0,0
4. SIGNIFICANT ACCOUNTING JUDGEMENTS AND KEY SOURCES OF ESTIMATION UNCERTAINTY,0,0,0,0,0
5. EXCEPTIONAL ITEMS,0,0,0,0,0
6. REVENUE,0,0,0,0,0
7. OTHER INFORMATION,0,0,0,0,0
11. STAFF COSTS,0,0,0,0,0
12. FINANCE INCOME,0,0,0,0,0
13. FINANCE COSTS,0,0,0,0,0
14. TAX,0,0,0,0,0
14. TAX CONTINUED,0,0,0,0,0
15. GOODWILL,0,0,0,0,0
15. GOODWILL CONTINUED,0,0,0,0,0
16. OTHER INTANGIBLE ASSETS,0,0,0,0,0
16. OTHER INTANGIBLE ASSETS CONTINUED,0,0,0,0,0
"17. PROPERTY, PLANT AND EQUIPMENT",0,0,0,0,0
"17. PROPERTY, PLANT AND EQUIPMENT CONTINUED",0,0,0,0,0
18. SUBSIDIARIES,0,0,0,0,0
19. JOINT VENTURES AND ASSOCIATES,0,0,0,0,0
19. JOINT VENTURES AND ASSOCIATES CONTINUED,0,0,0,0,0
20. INVENTORIES,0,0,0,0,0
21. TRADE AND OTHER RECEIVABLES,0,0,0,0,0
22. BORROWINGS,0,0,0,0,0
23. DEFERRED TAX,0,0,0,0,0
24. LEASES,0,0,0,0,0
24. LEASES CONTINUED,0,0,0,0,0
25. TRADE AND OTHER PAYABLES,0,0,0,0,0
26. CONTRACT LIABILITIES,0,0,0,0,0
27. PROVISIONS,0,0,0,0,0
28. SHARE CAPITAL,0,0,0,0,0
29. SHARE PREMIUM ACCOUNT,0,0,0,0,0
30. OTHER RESERVES,0,0,0,0,0
31. NOTES TO THE CASH FLOW STATEMENT,0,0,0,0,0
31. NOTES TO THE CASH FLOW STATEMENT CONTINUED,0,0,0,0,0
32. COMMITMENTS AND CONTINGENCIES,0,0,0,0,0
33. EMPLOYEE BENEFIT OBLIGATIONS,0,0,0,0,0
33. EMPLOYEE BENEFIT OBLIGATIONS CONTINUED,0,0,0,0,0
34. FINANCIAL INSTRUMENTS,0,0,0,0,0
34. FINANCIAL INSTRUMENTS CONTINUED,0,0,0,0,0
36. POST BALANCE SHEET EVENTS,0,0,0,0,0
37. RELATED PARTY TRANSACTIONS,0,0,0,0,0
39. SHARE-BASED PAYMENTS,0,0,0,0,0
1. GENERAL INFORMATION,0,0,0,0,0
2. BASIS OF PREPARATION,0,0,0,0,0
8. TRADE AND OTHER PAYABLES,0,0,0,0,0
"9. SHARE CAPITAL, SHARE PREMIUM ACCOUNT AND OTHER RESERVES",0,0,0,0,0
10. CONTROLLING PARTY,0,0,0,0,0
11. POST BALANCE SHEET EVENTS,0,0,0,0,0
BASIS FOR OPINION,0,0,0,0,0
FRAUD AND BREACHES OF LAWS AND REGULATIONS – ABILITY TO DETECT,0,0,0,0,0
DIRECTORS’ RESPONSIBILITIES,0,0,0,0,0
AUDITOR’S RESPONSIBILITIES,0,0,0,0,0
THE PURPOSE OF OUR AUDIT WORK AND TO WHOM WE OWE OUR RESPONSIBILITIES,0,0,0,0,0
27. PROVISIONS CONTINUED,0,0,0,0,0
IMPORTANT INFORMATION ABOUT THIS OFFERING CIRCULAR,0,0,0,0,0
SELLING RESTRICTIONS,0,0,0,0,0
SUSTAINABILITY-LINKED FINANCING FRAMEWORK,0,0,0,0,0
SUBSCRIPTION AND SALE OF THE NOTES,0,0,0,0,0
CERTAIN INSOLVENCY AND ENFORCEABILITY CONSIDERATIONS,0,0,0,0,0
INDEPENDENT STATUTORY AUDITORS,0,0,0,0,0
ISSUER,0,0,0,0,0
INDEPENDENT STATUTORY AUDITORS OF THE ISSUER,0,0,0,0,0
TRUSTEE AND PRINCIPAL PAYING AGENT** **REGISTRAR,0,0,0,0,0
IRISH LISTING AGENT,0,0,0,0,0
STABILISATION,0,0,0,0,0
NOTICE TO INVESTORS IN THE EUROPEAN ECONOMIC AREA AND IN THE UNITED KINGDOM,0,0,0,0,0
PRESENTATION OF FINANCIAL INFORMATION AND OTHER INFORMATION,0,0,0,0,0
RISKS RELATING TO OUR BUSINESS AND INDUSTRY,0,0,0,0,0
CERTAIN INSOLVENCY CONSIDERATIONS AND LIMITATIONS ON THE VALIDITY AND ENFORCEABILITY OF THE GUARANTEES AND SECURITY,0,0,0,0,0
INDEPENDENT REVIEW REPORT TO DRAX GROUP PLC,0,0,0,0,0
REGISTERED OFFICER OF THE ISSUER,0,0,0,0,0
LEGAL ADVISERS TO THE ISSUER AND THE GUARANTORS,0,0,0,0,0
OFFERING** **MEMORANDUM** **NOT FOR GENERAL DISTRIBUTION IN THE UNITED STATES,0,0,0,0,0
SUMMARY CONSOLIDATED FINANCIAL INFORMATION,0,0,0,0,0
MANAGEMENT’S DISCUSSION AND ANALYSIS OF RESULTS OF OPERATIONS AND FINANCIAL CONDITION,0,0,0,0,0
LIMITATIONS ON VALIDITY AND ENFORCEABILITY OF THE GUARANTEES AND THE NOTES COLLATERAL AND CERTAIN INSOLVENCY LAW CONSIDERATIONS,0,0,0,0,0
INTERIM FINANCIAL STATEMENTS STATEMENT OF FINANCIAL POSITION,0,0,0,0,0
"TOTAL EQUITY AND LIABILITIES . . . . . . . . . . . . . . . . . . . . . . . . . . . . . . . . . . . . . . .** **66,374",0,0,0,0,0
INTERIM FINANCIAL STATEMENTS INCOME STATEMENT,0,0,0,0,0
INTERIM FINANCIAL STATEMENTS STATEMENT OF COMPREHENSIVE INCOME,0,0,0,0,0
INTERIM FINANCIAL STATEMENTS STATEMENT OF CHANGES IN EQUITY,0,0,0,0,0
INTERIM FINANCIAL STATEMENTS STATEMENT OF CASH FLOW,0,0,0,0,0
SOFIMA HOLDING S.P.A.,0,0,0,0,0
B) GENERAL BASIS OF PREPARATION,0,0,0,0,0
NOTES TO THE FINANCIAL STATEMENTS,0,0,0,0,0
C) ACCOUNTING POLICIES AND STANDARDS,0,0,0,0,0
INVESTMENTS IN SUBSIDIARIES,0,0,0,0,0
IMPAIRMENT OF ASSETS,0,0,0,0,0
CASH AND CASH EQUIVALENTS,0,0,0,0,0
TAXES,0,0,0,0,0
EARNINGS PER SHARE,0,0,0,0,0
USE OF ESTIMATES AND ASSUMPTIONS,0,0,0,0,0
ACCOUNTING STANDARDS ISSUED BUT NOT YET IN FORCE,0,0,0,0,0
D) NOTES TO THE FINANCIAL STATEMENTS,0,0,0,0,0
1. INVESTMENTS IN SUBSIDIARIES,0,0,0,0,0
NOTES TO THE FINANCIAL STATEMENTS 4. EQUITY,0,0,0,0,0
5. TRADE AND OTHER PAYABLES,0,0,0,0,0
6. OPERATING COST,0,0,0,0,0
7. INCOME TAXES,0,0,0,0,0
8. EARNINGS PER SHARE,0,0,0,0,0
9. ATYPICAL AND/OR UNUSUAL TRANSACTIONS,0,0,0,0,0
10. SIGNIFICANT EVENTS AFTER THE CLOSE OF THE PERIOD,0,0,0,0,0
I.M.A. INDUSTRIA MACCHINE AUTOMATICHE S.P.A. AND SUBSIDIARIES,0,0,0,0,0
CONSOLIDATED FINANCIAL STATEMENTS CONSOLIDATED STATEMENT OF FINANCIAL POSITION,0,0,0,0,0
NON-CURRENT LIABILITIES,0,0,0,0,0
CONSOLIDATED FINANCIAL STATEMENTS CONSOLIDATED INCOME STATEMENT,0,0,0,0,0
OPERATING COSTS,0,0,0,0,0
FINANCIAL INCOME AND EXPENSE,0,0,0,0,0
PROFIT (LOSS) FROM INVESTMENTS ACCOUNTED FOR,0,0,0,0,0
CONSOLIDATED FINANCIAL STATEMENTS CONSOLIDATED STATEMENT OF COMPREHENSIVE INCOME,0,0,0,0,0
CONSOLIDATED FINANCIAL STATEMENTS STATEMENT OF CHANGES IN CONSOLIDATED EQUITY,0,0,0,0,0
CONSOLIDATED FINANCIAL STATEMENTS CONSOLIDATED STATEMENT OF CASH FLOWS,0,0,0,0,0
NOTES TO THE CONSOLIDATED FINANCIAL STATEMENTS A) OVERVIEW,0,0,0,0,0
B) GENERAL PREPARATION POLICIES,0,0,0,0,0
IMPACTS OF THE COVID-19 PANDEMIC ON THE PERIODIC FINANCIAL INFORMATION AND ON THE USE OF ESTIMATES AND ASSUMPTIONS,0,0,0,0,0
TRANSLATION OF FOREIGN CURRENCY BALANCES,0,0,0,0,0
D) FINANCIAL RISK MANAGEMENT RISK FACTORS,0,0,0,0,0
FAIR VALUE,0,0,0,0,0
E) SCOPE OF CONSOLIDATION,0,0,0,0,0
F) NOTES TO THE CONSOLIDATED FINANCIAL STATEMENTS,0,0,0,0,0
1. SEGMENT INFORMATION,0,0,0,0,0
"2. PROPERTY, PLANT AND EQUIPMENT AND RIGHT OF USE ASSETS PROPERTY, PLANT AND EQUIPMENT",0,0,0,0,0
RIGHT OF USE ASSETS,0,0,0,0,0
3. INTANGIBLE ASSETS,0,0,0,0,0
4. INVESTMENTS ACCOUNTED FOR USING THE EQUITY METHOD,0,0,0,0,0
5. FINANCIAL ASSETS,0,0,0,0,0
NOTES TO THE CONSOLIDATED FINANCIAL STATEMENTS 6. DERIVATIVE FINANCIAL INSTRUMENTS,0,0,0,0,0
7. DEFERRED TAX ASSETS AND LIABILITIES,0,0,0,0,0
8. INVENTORIES,0,0,0,0,0
9. TRADE AND OTHER RECEIVABLES AND CONTRACT ASSETS TRADE AND OTHER RECEIVABLES,0,0,0,0,0
CONTRACT ASSETS,0,0,0,0,0
10. CASH AND CASH EQUIVALENTS,0,0,0,0,0
11. EQUITY ATTRIBUTABLE TO EQUITY HOLDERS OF THE PARENT,0,0,0,0,0
NOTES TO THE CONSOLIDATED FINANCIAL STATEMENTS 12. NON-CONTROLLING INTERESTS,0,0,0,0,0
13. BORROWINGS AND LEASE LIABILITIES BORROWINGS,0,0,0,0,0
NET DEBT,0,0,0,0,0
14. EMPLOYEE DEFINED BENEFIT LIABILITIES,0,0,0,0,0
NOTES TO THE CONSOLIDATED FINANCIAL STATEMENTS 15. PROVISIONS FOR RISKS AND CHARGES,0,0,0,0,0
16. TRADE AND OTHER PAYABLES AND CONTRACT LIABILITIES TRADE AND OTHER PAYABLES,0,0,0,0,0
CONTRACT LIABILITIES,0,0,0,0,0
17. PERSONNEL COSTS,0,0,0,0,0
"18. DEPRECIATION, AMORTIZATION AND WRITE-DOWNS",0,0,0,0,0
19. FINANCIAL INCOME,0,0,0,0,0
NOTES TO THE CONSOLIDATED FINANCIAL STATEMENTS 20. FINANCIAL EXPENSE,0,0,0,0,0
21. TAXES,0,0,0,0,0
22. EARNINGS PER SHARE,0,0,0,0,0
23. BUSINESS COMBINATIONS,0,0,0,0,0
24. GUARANTEES GRANTED,0,0,0,0,0
25. COMMITMENTS,0,0,0,0,0
26. RELATED-PARTY TRANSACTIONS,0,0,0,0,0
28. ATYPICAL AND/OR UNUSUAL TRANSACTIONS,0,0,0,0,0
29. SIGNIFICANT EVENTS AFTER THE END OF THE THIRD QUARTER,0,0,0,0,0
NOTES TO THE CONSOLIDATED FINANCIAL STATEMENTS G) EQUITY INVESTMENTS INCLUDED IN THE SCOPE OF CONSOLIDATION AND METHOD USED,0,0,0,0,0
CONSOLIDATED INCOME STATEMENT,0,0,0,0,0
PROFIT (LOSS) FROM INVESTMENTS ACCOUNTED FOR USING,0,0,0,0,0
C) ACCOUNTING POLICIES AND ACCOUNTING STANDARDS APPLIED,0,0,0,0,0
"PROPERTY, PLANT AND EQUIPMENT",0,0,0,0,0
INTANGIBLE ASSETS,0,0,0,0,0
FINANCIAL ASSETS,0,0,0,0,0
HEDGING INSTRUMENTS,0,0,0,0,0
INVENTORIES,0,0,0,0,0
TRADE AND OTHER RECEIVABLES AND CONTRACT ASSETS,0,0,0,0,0
TREASURY SHARES,0,0,0,0,0
EMPLOYEE BENEFITS,0,0,0,0,0
BORROWINGS,0,0,0,0,0
OTHER PAYABLES,0,0,0,0,0
GOVERNMENT GRANTS,0,0,0,0,0
REVENUE FROM CONTRACTS WITH CUSTOMERS,0,0,0,0,0
DISCONTINUED OPERATIONS/DISPOSAL GROUPS,0,0,0,0,0
HYPERINFLATION,0,0,0,0,0
NOTES TO THE CONSOLIDATED FINANCIAL STATEMENTS DIVIDENDS,0,0,0,0,0
SEGMENT INFORMATION,0,0,0,0,0
MARKET RISK,0,0,0,0,0
CAPITAL RISK MANAGEMENT,0,0,0,0,0
E) CONSOLIDATION PRINCIPLES,0,0,0,0,0
F) SCOPE OF CONSOLIDATION,0,0,0,0,0
G) NOTES TO THE CONSOLIDATED FINANCIAL STATEMENTS,0,0,0,0,0
NOTES TO THE CONSOLIDATED FINANCIAL STATEMENTS 2018,0,0,0,0,0
NOTES TO THE CONSOLIDATED FINANCIAL STATEMENTS 2019,0,0,0,0,0
"NOTES TO THE CONSOLIDATED FINANCIAL STATEMENTS 2. PROPERTY, PLANT AND EQUIPMENT AND RIGHT OF USE ASSETS PROPERTY, PLANT AND EQUIPMENT",0,0,0,0,0
NOTES TO THE CONSOLIDATED FINANCIAL STATEMENTS RIGHT OF USE ASSETS,0,0,0,0,0
NOTES TO THE CONSOLIDATED FINANCIAL STATEMENTS 3. INTANGIBLE ASSETS,0,0,0,0,0
7. DERIVATIVE FINANCIAL INSTRUMENTS,0,0,0,0,0
8. DEFERRED TAX ASSETS AND LIABILITIES,0,0,0,0,0
9. INVENTORIES,0,0,0,0,0
10. TRADE AND OTHER RECEIVABLES AND CONTRACT ASSETS TRADE AND OTHER RECEIVABLES,0,0,0,0,0
NOTES TO THE CONSOLIDATED FINANCIAL STATEMENTS CONTRACT ASSETS,0,0,0,0,0
11. INCOME TAX RECEIVABLES AND PAYABLES,0,0,0,0,0
12. CASH AND CASH EQUIVALENTS,0,0,0,0,0
NOTES TO THE CONSOLIDATED FINANCIAL STATEMENTS 13. EQUITY ATTRIBUTABLE TO EQUITY HOLDERS OF THE PARENT,0,0,0,0,0
14. NON-CONTROLLING INTERESTS,0,0,0,0,0
15. BORROWINGS AND LEASE LIABILITIES BORROWINGS,0,0,0,0,0
CHANGES IN LIABILITIES DERIVING FROM FINANCING ACTIVITIES,0,0,0,0,0
16. EMPLOYEE DEFINED BENEFIT LIABILITIES,0,0,0,0,0
18. TRADE AND OTHER PAYABLES AND CONTRACT LIABILITIES TRADE AND OTHER PAYABLES,0,0,0,0,0
19. OTHER REVENUE AND CAPITALIZED COSTS,0,0,0,0,0
"20. COST OF RAW, ANCILLARY AND CONSUMABLE MATERIALS AND GOODS FOR RESALE",0,0,0,0,0
"21. SERVICES, RENTALS AND LEASES",0,0,0,0,0
22. PERSONNEL COSTS,0,0,0,0,0
"NOTES TO THE CONSOLIDATED FINANCIAL STATEMENTS 23. DEPRECIATION, AMORTIZATION AND WRITE-DOWNS",0,0,0,0,0
24. OTHER OPERATING COSTS,0,0,0,0,0
25. FINANCIAL INCOME,0,0,0,0,0
NOTES TO THE CONSOLIDATED FINANCIAL STATEMENTS 26. FINANCIAL EXPENSE,0,0,0,0,0
27. TAXES,0,0,0,0,0
28. PROFIT (LOSS) FROM DISCONTINUED OPERATIONS/DISPOSAL GROUPS,0,0,0,0,0
29. EARNINGS PER SHARE,0,0,0,0,0
30. BUSINESS COMBINATIONS,0,0,0,0,0
NOTES TO THE CONSOLIDATED FINANCIAL STATEMENTS 31. GUARANTEES GRANTED,0,0,0,0,0
32. COMMITMENTS,0,0,0,0,0
33. RELATED-PARTY TRANSACTIONS,0,0,0,0,0
34. SIGNIFICANT NON-RECURRING TRANSACTIONS AND EVENTS,0,0,0,0,0
35. ATYPICAL AND/OR UNUSUAL TRANSACTIONS,0,0,0,0,0
36. SIGNIFICANT EVENTS AFTER THE CLOSE OF THE PERIOD,0,0,0,0,0
NOTES TO THE CONSOLIDATED FINANCIAL STATEMENTS H) EQUITY INVESTMENTS INCLUDED IN THE SCOPE OF CONSOLIDATION AND METHOD USED,0,0,0,0,0
NOTES TO THE CONSOLIDATED FINANCIAL STATEMENTS I) DISCLOSURE REQUIRED UNDER ARTICLE 149-DUODECIES OF THE CONSOB ISSUERS’ REGULATION,0,0,0,0,0
NON-CURRENT LIABILITIES . . . . . . . . . . . . . . . . . . . . . . . . . . . . . . . .,0,0,0,0,0
CURRENT LIABILITIES . . . . . . . . . . . . . . . . . . . . . . . . . . . . . . . . . . . . .,0,0,0,0,0
PROFIT (LOSS) FROM INVESTMENTS,0,0,0,0,0
NOTES TO THE CONSOLIDATED FINANCIAL STATEMENTS FINANCIAL ASSETS,0,0,0,0,0
NOTES TO THE CONSOLIDATED FINANCIAL STATEMENTS INVENTORIES,0,0,0,0,0
NOTES TO THE CONSOLIDATED FINANCIAL STATEMENTS BORROWINGS,0,0,0,0,0
NOTES TO THE CONSOLIDATED FINANCIAL STATEMENTS ACCOUNTING STANDARDS ISSUED BUT NOT YET IN FORCE,0,0,0,0,0
NOTES TO THE CONSOLIDATED FINANCIAL STATEMENTS FAIR VALUE,0,0,0,0,0
ANALYSIS BY BUSINESS SEGMENT,0,0,0,0,0
ANALYSIS BY GEOGRAPHICAL AREA 2018,0,0,0,0,0
REVENUE BY BUSINESS CATEGORY 2018,0,0,0,0,0
REVENUE BY TIMING OF RECOGNITION 2018,0,0,0,0,0
NOTES TO THE CONSOLIDATED FINANCIAL STATEMENTS 2017,0,0,0,0,0
"NOTES TO THE CONSOLIDATED FINANCIAL STATEMENTS 2. PROPERTY, PLANT AND EQUIPMENT",0,0,0,0,0
NOTES TO THE CONSOLIDATED FINANCIAL STATEMENTS 4. INVESTMENTS ACCOUNTED FOR USING THE EQUITY METHOD,0,0,0,0,0
NOTES TO THE CONSOLIDATED FINANCIAL STATEMENTS EXCHANGE RATE DERIVATIVES,0,0,0,0,0
ADVANCES TO SUPPLIERS,0,0,0,0,0
TAX RECEIVABLES,0,0,0,0,0
OTHER RECEIVABLES,0,0,0,0,0
15. BORROWINGS,0,0,0,0,0
NOTES TO THE CONSOLIDATED FINANCIAL STATEMENTS PAYABLES TO BANKS,0,0,0,0,0
NOTES TO THE CONSOLIDATED FINANCIAL STATEMENTS 17. PROVISIONS FOR RISKS AND CHARGES,0,0,0,0,0
19. OTHER REVENUE,0,0,0,0,0
"NOTES TO THE CONSOLIDATED FINANCIAL STATEMENTS 21. SERVICES, RENTALS AND LEASES",0,0,0,0,0
"23. DEPRECIATION, AMORTIZATION AND WRITE-DOWNS",0,0,0,0,0
NOTES TO THE CONSOLIDATED FINANCIAL STATEMENTS 25. FINANCIAL INCOME,0,0,0,0,0
26. FINANCIAL EXPENSE,0,0,0,0,0
CONSOLIDATED STATEMENT OF CASH FLOWS,0,0,0,0,0
C) ACCOUNTING POLICIES AND PRINCIPLES,0,0,0,0,0
NOTES TO THE CONSOLIDATED FINANCIAL STATEMENTS CONTRACT WORK,0,0,0,0,0
TRADE RECEIVABLES AND OTHER RECEIVABLES,0,0,0,0,0
REVENUE RECOGNITION,0,0,0,0,0
NOTES TO THE CONSOLIDATED FINANCIAL STATEMENTS D) FINANCIAL RISK MANAGEMENT RISK FACTORS,0,0,0,0,0
3.** **INTANGIBLE ASSETS,0,0,0,0,0
5.** **FINANCIAL ASSETS,0,0,0,0,0
7.** **DERIVATIVE FINANCIAL INSTRUMENTS,0,0,0,0,0
8.** **DEFERRED TAX ASSETS AND LIABILITIES,0,0,0,0,0
9.** **INVENTORIES,0,0,0,0,0
10. TRADE RECEIVABLES AND OTHER RECEIVABLES,0,0,0,0,0
NOTES TO THE CONSOLIDATED FINANCIAL STATEMENTS 18. TRADE PAYABLES AND OTHER PAYABLES,0,0,0,0,0
28. EARNINGS PER SHARE,0,0,0,0,0
29. BUSINESS COMBINATIONS,0,0,0,0,0
30. GUARANTEES GRANTED,0,0,0,0,0
31. COMMITMENTS,0,0,0,0,0
32. RELATED-PARTY TRANSACTIONS,0,0,0,0,0
33. SIGNIFICANT NON-RECURRING TRANSACTIONS AND EVENTS,0,0,0,0,0
NOTES TO THE CONSOLIDATED FINANCIAL STATEMENTS 34. ATYPICAL AND/OR UNUSUAL TRANSACTIONS,0,0,0,0,0
35. SIGNIFICANT EVENTS AFTER THE CLOSE OF THE PERIOD,0,0,0,0,0
LEGAL ADVISORS TO THE ISSUER AND THE GUARANTOR(S),0,0,0,0,0
"IN MAKING AN INVESTMENT DECISION, YOU MUST RELY ON YOUR OWN EXAMINATION OF OUR BUSINESS AND THE TERMS OF THE OFFERING, INCLUDING THE MERITS AND RISKS INVOLVED. IN MAKING YOUR PURCHASE, YOU WILL BE DEEMED TO HAVE MADE CERTAIN ACKNOWLEDGMENTS, REPRESENTATIONS AND AGREEMENTS SET FORTH IN THIS OFFERING CIRCULAR UNDER THE CAPTION “NOTICE TO INVESTORS.” THE NOTES ARE SUBJECT TO RESTRICTIONS ON TRANSFERABILITY AND RESALE AND MAY NOT BE TRANSFERRED OR RESOLD EXCEPT AS PERMITTED UNDER THE SECURITIES ACT AND RELATED RULES AND REGULATIONS AND APPLICABLE STATE SECURITIES LAWS. YOU SHOULD BE AWARE THAT YOU MAY BE REQUIRED TO BEAR THE FINANCIAL RISKS OF THIS INVESTMENT FOR AN INDEFINITE PERIOD OF TIME. THE INITIAL PURCHASERS MAKE NO REPRESENTATION OR WARRANTY, EXPRESS OR IMPLIED, AS TO THE ACCURACY OR COMPLETENESS OF THE INFORMATION SET FORTH IN THIS OFFERING CIRCULAR, AND NOTHING CONTAINED IN THIS OFFERING CIRCULAR IS, OR SHALL BE RELIED UPON AS, A PROMISE OR REPRESENTATION, WHETHER AS TO THE PAST OR THE FUTURE. THE INITIAL PURCHASERS DO NOT ASSUME ANY RESPONSIBILITY FOR",0,0,0,0,0
"MARKET, INDUSTRY AND OTHER DATA",0,0,0,0,0
CERTAIN TERMS USED IN THIS OFFERING CIRCULAR,0,0,0,0,0
"LABL, INC. NOTES TO THE UNAUDITED PRO FORMA COMBINED FINANCIAL INFORMATION",0,0,0,0,0
"LABL, INC. AND SUBSIDIARIES CONSOLIDATED STATEMENTS OF OPERATIONS",0,0,0,0,0
"LABL, INC. AND SUBSIDIARIES CONSOLIDATED STATEMENTS OF COMPREHENSIVE (LOSS) INCOME",0,0,0,0,0
"LABL, INC. AND SUBSIDIARIES CONSOLIDATED BALANCE SHEETS",0,0,0,0,0
"LABL, INC. AND SUBSIDIARIES CONSOLIDATED STATEMENTS OF STOCKHOLDERS’ EQUITY",0,0,0,0,0
"LABL, INC. AND SUBSIDIARIES CONSOLIDATED STATEMENTS OF CASH FLOWS",0,0,0,0,0
CASH FLOWS FROM INVESTING ACTIVITIES:,0,0,0,0,0
CASH FLOWS FROM OPERATING ACTIVITIES:,0,0,0,0,0
"LABL, INC. AND SUBSIDIARIES CONDENSED CONSOLIDATED STATEMENTS OF OPERATIONS",0,0,0,0,0
"LABL, INC. AND SUBSIDIARIES CONDENSED CONSOLIDATED STATEMENTS OF COMPREHENSIVE LOSS",0,0,0,0,0
"LABL, INC. AND SUBSIDIARIES CONDENSED CONSOLIDATED BALANCE SHEETS",0,0,0,0,0
"LABL, INC. AND SUBSIDIARIES CONDENSED CONSOLIDATED STATEMENTS OF STOCKHOLDERS’ EQUITY",0,0,0,0,0
"LABL, INC. AND SUBSIDIARIES CONDENSED CONSOLIDATED STATEMENTS OF CASH FLOWS",0,0,0,0,0
"NON-GAAP, COMBINED AND AS ADJUSTED FINANCIAL MEASURES AND INFORMATION",0,0,0,0,0
FINANCIAL INFORMATION BY DIVISION,0,0,0,0,0
"TRADEMARKS, TRADENAMES AND SERVICE MARKS",0,0,0,0,0
CAUTIONARY STATEMENT REGARDING FORWARD-LOOKING INFORMATION,0,0,0,0,0
INDEPENDENT CERTIFIED PUBLIC ACCOUNTANTS,0,0,0,0,0
INDEX TO CONSOLIDATED FINANCIAL STATEMENTS,0,0,0,0,0
"PART I. FINANCIAL STATEMENTS TRIDENT TPI HOLDINGS, INC. CONSOLIDATED BALANCE SHEETS",0,0,0,0,0
"TRIDENT TPI HOLDINGS, INC. UNAUDITED CONSOLIDATED STATEMENTS OF OPERATIONS",0,0,0,0,0
"TRIDENT TPI HOLDINGS, INC. UNAUDITED CONSOLIDATED STATEMENTS OF COMPREHENSIVE LOSS",0,0,0,0,0
"TRIDENT TPI HOLDINGS, INC. UNAUDITED CONSOLIDATED STATEMENTS OF STOCKHOLDER’S EQUITY",0,0,0,0,0
"TRIDENT TPI HOLDINGS, INC. UNAUDITED CONSOLIDATED STATEMENTS OF CASH FLOWS",0,0,0,0,0
OPERATING ACTIVITIES:,0,0,0,0,0
INVESTING ACTIVITIES:,0,0,0,0,0
FINANCING ACTIVITIES:,0,0,0,0,0
NOTE 2. ACQUISITIONS,0,0,0,0,0
NOTE 4. GOODWILL AND INTANGIBLE ASSETS,0,0,0,0,0
NOTE 5. DEBT,0,0,0,0,0
NOTE 7. STOCKHOLDER’S EQUITY,0,0,0,0,0
NOTE 8. LEASES,0,0,0,0,0
NOTE 9. COMMITMENTS AND CONTINGENCIES,0,0,0,0,0
NOTE 11. SUBSEQUENT EVENT,0,0,0,0,0
REPORT OF INDEPENDENT CERTIFIED PUBLIC ACCOUNTANTS,0,0,0,0,0
"TRIDENT TPI HOLDINGS, INC. CONSOLIDATED BALANCE SHEETS",0,0,0,0,0
"TRIDENT TPI HOLDINGS, INC. CONSOLIDATED STATEMENTS OF OPERATIONS",0,0,0,0,0
"TRIDENT TPI HOLDINGS, INC. CONSOLIDATED STATEMENTS OF COMPREHENSIVE INCOME (LOSS)",0,0,0,0,0
"TRIDENT TPI HOLDINGS, INC. CONSOLIDATED STATEMENTS OF STOCKHOLDER’S EQUITY",0,0,0,0,0
"TRIDENT TPI HOLDINGS, INC. CONSOLIDATED STATEMENTS OF CASH FLOWS",0,0,0,0,0
NOTE 2. SUMMARY OF SIGNIFICANT ACCOUNTING POLICIES,0,0,0,0,0
NOTE 3. ACQUISITIONS,0,0,0,0,0
NOTE 5. ACCOUNTS RECEIVABLE AND FACTORING,0,0,0,0,0
NOTE 6. INVENTORIES,0,0,0,0,0
"NOTE 7. PROPERTY, PLANT AND EQUIPMENT",0,0,0,0,0
NOTE 8. LONG-TERM DEBT,0,0,0,0,0
NOTE 9. OTHER CURRENT LIABILITIES,0,0,0,0,0
NOTE 11. EMPLOYEE BENEFIT PLANS,0,0,0,0,0
NOTE 12. STOCKHOLDER’S EQUITY,0,0,0,0,0
NOTE 13. COMMITMENTS AND CONTINGENCIES,0,0,0,0,0
NOTE 15. RELATED PARTY TRANSACTIONS,0,0,0,0,0
NOTE 16. FIRE LOSS,0,0,0,0,0
NOTE 4. ACQUISITIONS,0,0,0,0,0
NOTE 5. GOODWILL AND INTANGIBLE ASSETS,0,0,0,0,0
NOTE 6. ACCOUNTS RECEIVABLE AND FACTORING,0,0,0,0,0
NOTE 7. INVENTORIES,0,0,0,0,0
NOTE 10. DEFERRED SALE AND LEASE TRANSACTION,0,0,0,0,0
NOTE 11. OTHER CURRENT AND LONG-TERM LIABILITIES,0,0,0,0,0
NOTE 13. EMPLOYEE BENEFIT PLANS,0,0,0,0,0
NOTE 14. STOCKHOLDER’S EQUITY,0,0,0,0,0
NOTE 15. COMMITMENTS AND CONTINGENCIES,0,0,0,0,0
NOTE 18. RELATED PARTY TRANSACTIONS,0,0,0,0,0
NOTE 19. FIRE LOSS,0,0,0,0,0
NOTE 20. SUBSEQUENT EVENT,0,0,0,0,0
NOTICE TO INVESTORS IN SWITZERLAND,0,0,0,0,0
PRO-FORMA MAR 2021,0,0,0,0,0
SUMMARY OFFERING TERMS,0,0,0,0,0
"SUMMARY OF COMPANY AND GROUP RUN-RATE, VIVACOM, UNAUDITED PRO FORMA AND CERTAIN OTHER FINANCIAL DATA",0,0,0,0,0
UNAUDITED PRO FORMA FINANCIAL INFORMATION,0,0,0,0,0
SELECTED COMPANY HISTORICAL FINANCIAL DATA,0,0,0,0,0
THE COMPANY’S MANAGEMENT’S DISCUSSION AND ANALYSIS OF FINANCIAL CONDITION AND RESULTS OF OPERATIONS,0,0,0,0,0
VIVACOM’S MANAGEMENT’S DISCUSSION AND ANALYSIS OF FINANCIAL CONDITION AND RESULTS OF OPERATIONS,0,0,0,0,0
DESCRIPTION OF THE NEW NOTES,0,0,0,0,0
RECONCILIATION OF CERTAIN FINANCIAL DATA PRESENTED HEREIN,0,0,0,0,0
CONDENSED CONSOLIDATED STATEMENT OF PROFIT OR LOSS AND OTHER,0,0,0,0,0
INDEPENDENT AUDITOR’S REPORT ON THE CONDENSED CONSOLIDATED INTERIM FINANCIAL STATEMENTS,0,0,0,0,0
INDEPENDENT AUDITOR’S REPORT ON THE CONSOLIDATED FINANCIAL STATEMENTS,0,0,0,0,0
CGU** **WAAC** **PGR,0,0,0,0,0
THE MERGER,0,0,0,0,0
"MARKET SHARE, RANKING AND INDUSTRY DATA AND FORECASTS",0,0,0,0,0
"TRADEMARKS, SERVICE MARKS AND COPYRIGHTS",0,0,0,0,0
REPORT OF INDEPENDENT AUDITORS,0,0,0,0,0
"ASSUREDPARTNERS, INC. NOTES TO CONSOLIDATED FINANCIAL STATEMENTS",0,0,0,0,0
"ASSUREDPARTNERS, INC. NOTES TO CONSOLIDATED FINANCIAL STATEMENTS (UNAUDITED)",0,0,0,0,0
NOTICE TO INVESTORS IN FRANCE,0,0,0,0,0
NOTICE TO INVESTORS IN SPAIN,0,0,0,0,0
THIS OFFERING MEMORANDUM CONTAINS IMPORTANT INFORMATION WHICH YOU SHOULD READ BEFORE YOU MAKE ANY DECISION WITH RESPECT TO AN INVESTMENT IN THE NOTES. INFORMATION REGARDING FORWARD-LOOKING STATEMENTS,0,0,0,0,0
PRESENTATION OF INDUSTRY AND MARKET INFORMATION,0,0,0,0,0
SELECTED CONSOLIDATED FINANCIAL INFORMATION AND OTHER DATA,0,0,0,0,0
GENERAL INFORMATION,0,0,0,0,0
SUB LECTA SA,0,0,0,0,0
TORRASPAPEL SA,0,0,0,0,0
CASH FLOWS FROM INVESTING ACTIVITIES,0,0,0,0,0
CASH FLOWS FROM FINANCING ACTIVITIES,0,0,0,0,0
LEGAL ADVISORS TO THE ISSUER AND GUARANTORS,0,0,0,0,0
NOT FOR GENERAL CIRCULATION IN THE UNITED STATES,0,0,0,0,0
"THE NOTES MAY NOT BE OFFERED TO THE PUBLIC WITHIN ANY JURISDICTION. BY ACCEPTING DELIVERY OF THIS OFFERING MEMORANDUM, YOU AGREE NOT TO OFFER, SELL, RESELL, TRANSFER OR DELIVER, DIRECTLY OR INDIRECTLY, ANY NOTES TO THE PUBLIC.",0,0,0,0,0
NOTICE TO NORWEGIAN INVESTORS,0,0,0,0,0
NOTICE TO DANISH INVESTORS,0,0,0,0,0
NOTICE TO SWEDISH INVESTORS,0,0,0,0,0
CERTAIN DEFINITIONS AND PRESENTATION OF FINANCIAL AND OTHER INFORMATION,0,0,0,0,0
SUMMARY CONSOLIDATED FINANCIAL INFORMATION AND OTHER FINANCIAL DATA,0,0,0,0,0
SELECTED CONSOLIDATED FINANCIAL INFORMATION OF INEOS GROUP HOLDINGS PLC,0,0,0,0,0
USE OF NON-GAAP FINANCIAL MEASURES,0,0,0,0,0
DESCRIPTION OF THE COLLATERAL AND THE GUARANTEES,0,0,0,0,0
"EACH PROSPECTIVE PURCHASER IS URGED TO CONSULT ITS OWN TAX ADVISOR ABOUT THE U.S. FEDERAL, STATE AND LOCAL TAX CONSEQUENCES OF PURCHASING, HOLDING AND DISPOSING OF THE NOTES.",0,0,0,0,0
3. DISPOSALS,0,0,0,0,0
4. ACQUISITIONS OF SUBSIDIARIES,0,0,0,0,0
6. EXPENSES AND AUDITORS’ REMUNERATION,0,0,0,0,0
7. STAFF NUMBERS AND COSTS,0,0,0,0,0
20. INTEREST-BEARING LOANS AND BORROWINGS,0,0,0,0,0
22. EMPLOYEE BENEFITS,0,0,0,0,0
28. CAPITAL COMMITMENTS,0,0,0,0,0
31. ULTIMATE PARENT UNDERTAKING AND CONTROLLING PARTY,0,0,0,0,0
33. ACCOUNTING ESTIMATES AND JUDGEMENTS,0,0,0,0,0
"THE SECURITIES OFFERED HEREBY HAVE NOT BEEN RECOMMENDED BY ANY U.S. FEDERAL OR STATE SECURITIES COMMISSION OR REGULATORY AUTHORITY. FURTHERMORE, THE FOREGOING AUTHORITIES HAVE NOT CONFIRMED THE ACCURACY OR DETERMINED THE ADEQUACY OF THIS DOCUMENT. ANY REPRESENTATION TO THE CONTRARY IS A CRIMINAL OFFENSE.",0,0,0,0,0
SPECIAL NOTE ABOUT FORWARD-LOOKING STATEMENTS,0,0,0,0,0
SUMMARY HISTORICAL FINANCIAL DATA OF WYNDHAM HOTELS & RESORTS,0,0,0,0,0
LISTING PARTICULARS** **NOT FOR GENERAL DISTRIBUTION IN THE UNITED STATES,0,0,0,0,0
SUMMARY HISTORICAL CONSOLIDATED/COMBINED AND UNAUDITED PRO FORMA FINANCIAL INFORMATION,0,0,0,0,0
SELECTED CONSOLIDATED AND COMBINED FINANCIAL INFORMATION,0,0,0,0,0
EBIT,0,0,0,0,0
MARKET AND COMPETITIVE ENVIRONMENT,0,0,0,0,0
"BOOK-ENTRY, DELIVERY AND FORM GENERAL",0,0,0,0,0
ISSUANCE OF DEFINITIVE REGISTERED NOTES,0,0,0,0,0
REDEMPTION OF GLOBAL NOTES,0,0,0,0,0
PAYMENTS ON GLOBAL NOTES,0,0,0,0,0
CURRENCY AND PAYMENT FOR THE GLOBAL NOTES,0,0,0,0,0
TRANSFERS,0,0,0,0,0
INFORMATION CONCERNING EUROCLEAR AND CLEARSTREAM,0,0,0,0,0
GLOBAL CLEARANCE AND SETTLEMENT UNDER THE BOOK-ENTRY SYSTEM,0,0,0,0,0
INITIAL SETTLEMENT,0,0,0,0,0
SECONDARY MARKET TRADING,0,0,0,0,0
CERTAIN TAX CONSEQUENCES GERMAN TAXATION,0,0,0,0,0
PROSPECTIVE INVESTORS ARE RECOMMENDED TO CONSULT THEIR OWN TAX ADVISORS AS TO THE INDIVIDUAL TAX CONSEQUENCES ARISING FROM THE INVESTMENT IN THE NOTES. U.S. TAXATION,0,0,0,0,0
POLISH TAXATION,0,0,0,0,0
CERTAIN INSOLVENCY LAW CONSIDERATIONS AND LIMITATIONS ON THE VALIDITY AND ENFORCEABILITY OF THE NOTE GUARANTEES AND SECURITY INTERESTS EUROPEAN UNION,0,0,0,0,0
LISTING AND GENERAL INFORMATION LISTING,0,0,0,0,0
CLEARING INFORMATION,0,0,0,0,0
LEGAL INFORMATION,0,0,0,0,0
ORIGINAL SUBSIDIARY GUARANTORS,0,0,0,0,0
"SECURITY AGENT, PRINCIPAL PAYING** **REGISTRAR, LISTING AGENT AND",0,0,0,0,0
LANGUAGE OF DOCUMENTS,0,0,0,0,0
CONCURRENT OFFERING,0,0,0,0,0
SUMMARY HISTORICAL AND UNAUDITED PRO FORMA FINANCIAL INFORMATION,0,0,0,0,0
ROCKET’S MANAGEMENT’S DISCUSSION AND ANALYSIS OF FINANCIAL CONDITION AND RESULTS OF OPERATIONS,0,0,0,0,0
AMC BUSINESS’S MANAGEMENT’S DISCUSSION AND ANALYSIS OF FINANCIAL CONDITION AND RESULTS OF OPERATIONS,0,0,0,0,0
"PROSPECTIVE INVESTORS ARE URGED TO CONSULT THEIR TAX ADVISORS AS TO FRENCH TAX CONSIDERATIONS RELATING TO THE PURCHASE, OWNERSHIP AND DISPOSAL OF THE NOTES IN LIGHT OF THEIR PARTICULAR CIRCUMSTANCES.",0,0,0,0,0
INDEPENDENT STATUTORY AUDITOR,0,0,0,0,0
INETUM,0,0,0,0,0
1.1. BASIS OF PREPARATION,0,0,0,0,0
1.2. NEW STANDARDS AND INTERPRETATIONS,0,0,0,0,0
1.3. ACCOUNTING ESTIMATES AND JUDGEMENTS,0,0,0,0,0
2.2. IMPACT OF CHANGES IN CONSOLIDATION SCOPE,0,0,0,0,0
"TOTAL . . . . . . . . . . . . . . . . . . . . . . . . . . . . . . . . . . . . . . . . . . . . . . . . . . . . . . . . . . . . . . .** **48,431",0,0,0,0,0
"NET CASH FLOW . . . . . . . . . . . . . . . . . . . . . . . . . . . . . . . . . . . . . . . . . . . . . . . . . . . . . . .** **43,141",0,0,0,0,0
3.2. SEGMENT INFORMATION,0,0,0,0,0
8.3. CASH GENERATING UNITS AND IMPAIRMENTS TESTS,0,0,0,0,0
SENSITIVITY TESTING FOR EACH CGU,0,0,0,0,0
10.1. CHANGE IN SHARE CAPITAL,0,0,0,0,0
10.3. TREASURY SHARE TRANSACTIONS,0,0,0,0,0
10.4. DIVIDENDS,0,0,0,0,0
10.5. RELATED PARTIES DISCLOSURES,0,0,0,0,0
GRANT THORNTON,0,0,0,0,0
1.1. STANDARD USED,0,0,0,0,0
1.2. BASIS OF PREPARATION,0,0,0,0,0
1.3. PRESENTATION,0,0,0,0,0
CLOSING DATE OF THE FINANCIAL STATEMENTS,0,0,0,0,0
PROJIXI ACQUISITION,0,0,0,0,0
ILEX ACQUISITION,0,0,0,0,0
GROUP HLI ACQUISITION,0,0,0,0,0
2.3. IMPACT OF CHANGE IN CONSOLIDATION SCOPE,0,0,0,0,0
"TOTAL . . . . . . . . . . . . . . . . . . . . . . . . . . . . . . . . . . . . . . . . . . . . . . . . . . . . . . . . . . . . . . .** **27,041",0,0,0,0,0
"TECHNICAL ASSISTANCE, CONSULTING AND SYSTEMS INTEGRATION BILLED AT COST PLUS",0,0,0,0,0
SERVICES INVOICED FOR A FIXED AMOUNT,0,0,0,0,0
SYSTEMS INTEGRATION ASSOCIATED WITH SALES OF SOFTWARE PACKAGES AND HARDWARE,0,0,0,0,0
MAINTENANCE,0,0,0,0,0
TRANSACTIONS CARRIED OUT AS AN AGENT,0,0,0,0,0
3.3. TRADE RECEIVABLES TRADE RECEIVABLES,0,0,0,0,0
IMPAIRMENT OF TRADE RECEIVABLES,0,0,0,0,0
FACTORING,0,0,0,0,0
RESEARCH COSTS,0,0,0,0,0
RESEARCH TAX CREDITS,0,0,0,0,0
5.2. NET OPERATING INCOME,0,0,0,0,0
INTANGIBLE ASSETS RECOGNIZED FROM BUSIESS COMBINATIONS,0,0,0,0,0
COSTS RELATED TO ACQUISITIONS,0,0,0,0,0
OTHER ITEMS,0,0,0,0,0
FREE SHARES,0,0,0,0,0
OTHERS,0,0,0,0,0
FINANCIAL NET DEBT,0,0,0,0,0
6.2. FINANCIAL LIABILITIES DERIVATIVE FINANCIAL INSTRUMENTS,0,0,0,0,0
HEDGE ACCOUNTING,0,0,0,0,0
6.4. INTEREST RATE RISK ON CASH FLOW,0,0,0,0,0
6.5. LIQUIDITY RISK,0,0,0,0,0
6.7. OFF BALANCE SHEET COMMITMENTS RELATING TO THE COMPANY’S FINANCING ACTIVITIES,0,0,0,0,0
CONTRACTUAL LIMITATIONS TO THE GROUP’S DIVIDEND PAYOUT POLICY,0,0,0,0,0
CEILING ON INVESTMENTS,0,0,0,0,0
CURRENT TAXES,0,0,0,0,0
DEFERRED TAXES,0,0,0,0,0
7.1. INCOME TAX EXPENSE,0,0,0,0,0
7.2. RECONCILIATION OF THEORETICAL AND ACTUAL INCOME TAX EXPENSE,0,0,0,0,0
8.3. CASH GENERATING UNITS AND IMPAIRMENTS TESTS CASH GENERATING UNITS (GCU),0,0,0,0,0
IMPAIRMENT TEST,0,0,0,0,0
IN FRANCE,0,0,0,0,0
IN INTERNATIONAL,0,0,0,0,0
8.4. OTHER INTANGIBLES ASSETS,0,0,0,0,0
CUSTOMER RELATIONS,0,0,0,0,0
SOFTWARE,0,0,0,0,0
"8.5. PROPERTY, PLANT AND EQUIPMENT",0,0,0,0,0
DEPRECIATIONS,0,0,0,0,0
RECOGNITION OF A LEASE CONTRACT,0,0,0,0,0
REEVALUATION,0,0,0,0,0
9.1. RIGHT OF USE,0,0,0,0,0
10.3. TREASURY SHARES TRANSACTIONS,0,0,0,0,0
10.5. FREE SHARES PLANS,0,0,0,0,0
FINANCIAL ASSETS AT THEIR FAIR VALUE WITH THE OFFSETTING ENTRY IN THE INCOME STATEMENT,0,0,0,0,0
LOANS AND RECEIVABLES,0,0,0,0,0
14.4.** **OBJECTIVES AND FINANCIAL RISK MANAGEMENT POLICY,0,0,0,0,0
"TOTAL . . . . . . . . . . . . . . . . . . . . . . . . . . . . . . . . . . . . . . . . . . . . . . . . . . . . . . . . . . . . . .** **276,500",0,0,0,0,0
SALES OF SOFTWARE AND HARDWARE,0,0,0,0,0
6.2. DEBT LOANS,0,0,0,0,0
6.3. FINANCIAL LIABILITIES DERIVATIVE FINANCIAL INSTRUMENTS,0,0,0,0,0
6.6. LIQUIDITY RISK,0,0,0,0,0
6.8. OFF BALANCE SHEET COMMITMENTS RELATING TO THE COMPANY’S FINANCING ACTIVITIES,0,0,0,0,0
DEVELOPMENT COSTS,0,0,0,0,0
HELD-TO-MATURITY ASSETS,0,0,0,0,0
14.4. OBJECTIVES AND FINANCIAL RISK MANAGEMENT POLICY,0,0,0,0,0
1.2. BASIS OF PRESENTATION,0,0,0,0,0
ACQUISITION OF HUNDRED,0,0,0,0,0
ACQUISITION OF I2S,0,0,0,0,0
ACQUISITION OF CAPITAL CONSULTING,0,0,0,0,0
OTHER ACQUISITIONS,0,0,0,0,0
2.3. IMPACT OF CHANGES IN CONSOLIDATION SCOPE,0,0,0,0,0
"TOTAL** . . . . . . . . . . . . . . . . . . . . . . . . . . . . . . . . . . . . . . . . . . . . . . . . . . . . . . . . . . . . . . **63,182",0,0,0,0,0
"NET CASH FLOW . . . . . . . . . . . . . . . . . . . . . . . . . . . . . . . . . . . . . . . . . . . . . . . . . . . . . .** **26,744",0,0,0,0,0
3.2. SEGMENT OPERATING,0,0,0,0,0
RESEARCH TAX CREDIT,0,0,0,0,0
DEBT ON LEASES CONTRACTS,0,0,0,0,0
FINANCIAL DEBT,0,0,0,0,0
FINANCING FROM CREDIT INSTITUTIONS,0,0,0,0,0
7.1. RECONCILIATION OF THEORETICAL AND ACTUAL INCOME TAX EXPENSE,0,0,0,0,0
8.2. GOODWILL,0,0,0,0,0
SUBSEQUENT MEASUREMENT OF NON-CURRENT ASSETS,0,0,0,0,0
INTERNATIONAL,0,0,0,0,0
8.3. OTHER INTANGIBLE ASSETS,0,0,0,0,0
CUSTOMER RELATIONSHIPS,0,0,0,0,0
COMPUTER SOFTWARE,0,0,0,0,0
"8.4. PROPERTY, PLANT AND EQUIPMENT",0,0,0,0,0
AMORTIZATION,0,0,0,0,0
RENTAL CONTRACTS,0,0,0,0,0
9.1. CHANGE IN SHARE CAPITAL,0,0,0,0,0
9.3. TREASURY SHARE TRANSACTIONS,0,0,0,0,0
10.3. VARIOUS RISKS,0,0,0,0,0
13.4. OBJECTIVES AND FINANCIAL RISK MANAGEMENT POLICY,0,0,0,0,0
RENEGOTIATION OF THE SYNDICATED LOAN CONTRACT,0,0,0,0,0
"MANAGER”) AND J.P. MORGAN AG (THE “PIK STABILIZING MANAGER” AND, TOGETHER WITH",0,0,0,0,0
"THE NOTES MAY NOT BE OFFERED TO THE PUBLIC WITHIN ANY JURISDICTION. BY ACCEPTING DELIVERY OF THIS OFFERING MEMORANDUM, YOU AGREE NOT TO OFFER, SELL, RESELL, TRANSFER OR DELIVER, DIRECTLY OR INDIRECTLY, ANY NOTES TO THE PUBLIC. NOTICE TO EUROPEAN ECONOMIC AREA INVESTORS",0,0,0,0,0
DESCRIPTION OF THE PIK NOTES,0,0,0,0,0
"PROSPECTIVE INVESTORS ARE URGED TO CONSULT THEIR OWN TAX ADVISERS AS TO FRENCH TAX CONSIDERATIONS RELATING TO THE PURCHASE, OWNERSHIP AND DISPOSAL OF THE PIK NOTES IN LIGHT OF THEIR PARTICULAR CIRCUMSTANCES.",0,0,0,0,0
CERTAIN INSOLVENCY LAW CONSIDERATIONS AND LIMITATIONS ON THE VALIDITY AND ENFORCEABILITY OF THE SSN GUARANTEES AND THE COLLATERAL,0,0,0,0,0
IFRS 5,0,0,0,0,0
NON-CURRENT FINANCIAL LIABILITIES,0,0,0,0,0
KPMG** **EXELMANS,0,0,0,0,0
KPMG SA,0,0,0,0,0
UNAUDITED PRO FORMA FINANCIAL INFORMATION OF THE PARENT,0,0,0,0,0
"PROSPECTIVE INVESTORS ARE URGED TO CONSULT THEIR OWN TAX ADVISERS AS TO FRENCH TAX CONSIDERATIONS RELATING TO THE PURCHASE, OWNERSHIP AND DISPOSAL OF THE NOTES IN LIGHT OF THEIR PARTICULAR CIRCUMSTANCES.",0,0,0,0,0
CERTAIN INSOLVENCY LAW CONSIDERATIONS AND LIMITATIONS ON THE VALIDITY AND ENFORCEABILITY OF THE GUARANTEES AND THE COLLATERAL,0,0,0,0,0
BERTRAND FRANCHISE S.A.S.,0,0,0,0,0
BERTRAND FRANCHISE S A S,0,0,0,0,0
LEASE AGREEMENTS,0,0,0,0,0
LEASE RIGHTS,0,0,0,0,0
STATUTORY AUDITORS OF THE PARENT AND BURGER KING FRANCE KPMG S.A.,0,0,0,0,0
"THE NOTES MAY NOT BE OFFERED TO THE PUBLIC WITHIN ANY JURISDICTION. BY ACCEPTING DELIVERY OF THIS LISTING PROSPECTUS, YOU AGREE NOT TO OFFER, SELL, RESELL, TRANSFER OR DELIVER, DIRECTLY OR INDIRECTLY, ANY NOTES TO THE PUBLIC. NOTICE TO EUROPEAN ECONOMIC AREA INVESTORS",0,0,0,0,0
LISTING PROSPECTUS,0,0,0,0,0
"THIS CONFIDENTIAL OFFERING MEMORANDUM DOES NOT CONSTITUTE AN OFFER TO SELL, OR A SOLICITATION OF AN OFFER TO BUY, ANY NOTE OFFERED BY THIS OFFERING MEMORANDUM BY ANY PERSON IN ANY JURISDICTION IN WHICH IT IS UNLAWFUL FOR SUCH PERSON TO MAKE SUCH AN OFFER OR SOLICITATION. NEITHER THE DELIVERY OF THIS OFFERING MEMORANDUM NOR ANY SALE MADE HEREUNDER SHALL UNDER ANY CIRCUMSTANCES IMPLY THAT THERE HAS BEEN NO CHANGE IN OUR AFFAIRS OR THE AFFAIRS OF OUR SUBSIDIARIES OR THAT THE INFORMATION SET FORTH IN THIS OFFERING MEMORANDUM, OR INCORPORATED BY REFERENCE IN THIS OFFERING MEMORANDUM, IS CORRECT AS OF ANY DATE SUBSEQUENT TO THE DATE OF THIS OFFERING MEMORANDUM, OR THE DATE OF THE INCORPORATED DOCUMENT, AS APPLICABLE.",0,0,0,0,0
"IN MAKING AN INVESTMENT DECISION, YOU MUST RELY ON YOUR OWN EXAMINATION OF OUR BUSINESS AND THE TERMS OF THE OFFERING, INCLUDING THE MERITS AND RISKS INVOLVED. THE NOTES HAVE NOT BEEN RECOMMENDED, APPROVED, OR DISAPPROVED BY ANY FEDERAL OR STATE SECURITIES COMMISSION OR REGULATORY AUTHORITY. FURTHERMORE, THESE AUTHORITIES HAVE NOT CONFIRMED THE ACCURACY OR DETERMINED THE ADEQUACY OF THIS OFFERING MEMORANDUM. ANY REPRESENTATION TO THE CONTRARY IS A CRIMINAL OFFENSE. THE NOTES ARE SUBJECT TO RESTRICTIONS ON TRANSFERABILITY AND RESALE AND MAY NOT BE TRANSFERRED OR RESOLD EXCEPT AS PERMITTED UNDER THE INDENTURE GOVERNING THE NOTES, THE SECURITIES ACT, THE REGULATIONS PROMULGATED THEREUNDER, AND ANY OTHER APPLICABLE LAW. YOU SHOULD BE AWARE THAT YOU MAY BE REQUIRED TO BEAR THE FINANCIAL RISKS OF THIS INVESTMENT FOR AN INDEFINITE PERIOD.",0,0,0,0,0
USE OF NON-GAAP MEASURES,0,0,0,0,0
SUMMARY HISTORICAL AND UNAUDITED PRO FORMA FINANCIAL DATA,0,0,0,0,0
UNAUDITED PRO FORMA FINANCIAL STATEMENTS,0,0,0,0,0
"THESE SECURITIES ARE SUBJECT TO RESTRICTIONS ON TRANSFERABILITY AND RESALE AND MAY NOT BE TRANSFERRED OR RESOLD EXCEPT AS PERMITTED UNDER THE SECURITIES ACT, APPLICABLE STATE SECURITIES LAWS AND APPLICABLE",0,0,0,0,0
"TRADEMARKS, TRADE NAMES AND COPYRIGHTS",0,0,0,0,0
"SHARE, RANKING AND SIMILAR INFORMATION",0,0,0,0,0
NOTES TO UNAUDITED PRO FORMA CONDENSED COMBINED BALANCE SHEET,0,0,0,0,0
NOTES TO UNAUDITED PRO FORMA CONDENSED COMBINED STATEMENT OF OPERATIONS,0,0,0,0,0
SELECTED COMBINED HISTORICAL FINANCIAL INFORMATION,0,0,0,0,0
DIVERSEY BUSINESS,0,0,0,0,0
CERTAIN INSOLVENCY LAW CONSIDERATIONS AND LIMITATIONS ON THE VALIDITY AND ENFORCEABILITY OF THE NOTE GUARANTEES AND THE SECURITY INTERESTS,0,0,0,0,0
4 BUSINESS AREA INFORMATION,0,0,0,0,0
"8 DEPRECIATION, AMORTIZATION AND IMPAIRMENT",0,0,0,0,0
11 EARNINGS PER SHARE,0,0,0,0,0
13 INVENTORIES,0,0,0,0,0
14 TRADE AND OTHER RECEIVABLES AND TRADE AND OTHER PAYABLES,0,0,0,0,0
15 DEFINED BENEFIT OBLIGATION,0,0,0,0,0
17 NET DEBT,0,0,0,0,0
18 EQUITY,0,0,0,0,0
20 OFF-BALANCE SHEET COMMITMENTS,0,0,0,0,0
"21** **AHLSTROM-MUNKSJÖ** **SUBSIDIARIES,** **ASSOCIATES** **AND** **JOINT** **OPERATIONS** **AND RELATED PARTY TRANSACTIONS",0,0,0,0,0
22 AUDITOR REMUNERATION,0,0,0,0,0
24 POST-BALANCE SHEET EVENTS,0,0,0,0,0
6 OTHER OPERATING EXPENSES,0,0,0,0,0
7 EMPLOYEE AND BOARD OF DIRECTORS REMUNERATION,0,0,0,0,0
15 DEFINED BENEFIT OBLIGATIONS,0,0,0,0,0
20 OFF–BALANCE SHEET COMMITMENTS,0,0,0,0,0
24 POST–BALANCE SHEET EVENTS,0,0,0,0,0
5 SOURCES OF REVENUE,0,0,0,0,0
"21 AHLSTROM-MUNKSJÖ SUBSIDIARIES, ASSOCIATES AND JOINT OPERATIONS AND RELATED PARTY TRANSACTIONS",0,0,0,0,0
IFRIC 23,0,0,0,0,0
CAUTIONARY NOTE CONCERNING FORWARD-LOOKING STATEMENTS,0,0,0,0,0
WHERE YOU CAN FIND MORE INFORMATION; INCORPORATION OF DOCUMENTS BY REFERENCE,0,0,0,0,0
SUMMARY HISTORICAL AND OTHER DATA,0,0,0,0,0
GLOSSARY OF INDUSTRY TERMS,0,0,0,0,0
SUMMARY HISTORICAL CONSOLIDATED FINANCIAL AND OTHER INFORMATION,0,0,0,0,0
UNDERLYING FINANCIAL DATA DERIVED FROM MANAGEMENT ACCOUNTS,0,0,0,0,0
SUPPLEMENTAL UNDERLYING FINANCIAL INFORMATION,0,0,0,0,0
TRUSTEE,0,0,0,0,0
PAYING AGENT** **REGISTRAR AND** **SECURITY AGENT,0,0,0,0,0
CONFIDENTIAL** **NOT FOR GENERAL CIRCULATION PRELIMINARY OFFERING MEMORANDUM** **IN THE UNITED STATES,0,0,0,0,0
OUR CORPORATE AND FINANCING STRUCTURE,0,0,0,0,0
SUMMARY HISTORICAL FINANCIAL AND OTHER DATA OF ACURIS INTERNATIONAL LIMITED,0,0,0,0,0
SUMMARY UNAUDITED PRO FORMA COMBINED FINANCIAL INFORMATION,0,0,0,0,0
SELECTED HISTORICAL FINANCIAL DATA OF THE PARENT GUARANTOR,0,0,0,0,0
SELECTED HISTORICAL FINANCIAL DATA OF ACURIS,0,0,0,0,0
GLOSSARY AND TECHNICAL TERMS,0,0,0,0,0
ASSETS EMPLOYED,0,0,0,0,0
"THIS OFFERING MEMORANDUM CONTAINS IMPORTANT INFORMATION, WHICH YOU SHOULD READ BEFORE YOU MAKE ANY DECISION WITH RESPECT TO AN INVESTMENT IN THE NEW NOTES.",0,0,0,0,0
CERTAIN LIMITATIONS ON THE VALIDITY AND ENFORCEABILITY OF THE NOTES GUARANTEES AND THE COLLATERAL,0,0,0,0,0
CONDENSED CONSOLIDATED INTERIM** **STATEMENT OF FINANCIAL POSITION,0,0,0,0,0
SELECTED EXPLANATORY NOTES TO THE CONDENSED CONSOLIDATED INTERIM FINANCIAL STATEMENTS,0,0,0,0,0
I-LOGIC** **TECHNOLOGIES** **BIDCO** **LIMITED COMPANY INFORMATION,0,0,0,0,0
COMPANY INFORMATION,0,0,0,0,0
CERTAIN INSOLVENCY LAW CONSIDERATIONS AND LIMITATIONS ON THE VALIDITY AND ENFORCEABILITY OF THE NOTE GUARANTEES AND SECURITY INTERESTS,0,0,0,0,0
SUMMARY OF CERTAIN DIFFERENCES BETWEEN GERMAN GAAP COMPARED TO IFRS RELATED TO MANAGEMENT’S KEY PERFORMANCE MEASURES,0,0,0,0,0
AUDIT OPINIONS,0,0,0,0,0
BASIS FOR THE AUDIT OPINIONS,0,0,0,0,0
RESPONSIBILITIES OF THE EXECUTIVE DIRECTORS FOR THE CONSOLIDATED FINANCIAL STATEMENTS AND THE GROUP MANAGEMENT REPORT,0,0,0,0,0
AUDITOR** **RESPONSIBILITIES** **FOR** **THE** **AUDIT** **OF** **THE** **CONSOLIDATED** **FINANCIAL STATEMENTS AND OF THE GROUP MANAGEMENT REPORT,0,0,0,0,0
C O N S O L I D A T E D B A L AN C E S H E E T,0,0,0,0,0
PROHIBITION OF OFFERS TO UNITED KINGDOM RETAIL INVESTORS,0,0,0,0,0
"SUBSCRIBER, INDUSTRY AND MARKET DATA",0,0,0,0,0
SUMMARY HISTORICAL AND PRO FORMA FINANCIAL INFORMATION AND OTHER DATA,0,0,0,0,0
MANAGEMENT’S DISCUSSION AND ANALYSIS OF FINANCIAL CONDITION AND RESULTS OF OPERATIONS OF MASMOVIL,0,0,0,0,0
MANAGEMENT’S DISCUSSION AND ANALYSIS OF FINANCIAL CONDITION AND RESULTS OF OPERATIONS OF THE TARGET GROUP,0,0,0,0,0
DESCRIPTION OF MASMOVIL’S BUSINESS,0,0,0,0,0
CERTAIN INSOLVENCY LAW CONSIDERATIONS AND LIMITATIONS ON NOTES GUARANTEES AND SECURITY,0,0,0,0,0
"MASMOVIL IBERCOM, S.A. AND SUBSIDIARIES",0,0,0,0,0
2. CRITICAL ACCOUNTING JUDGEMENTS AND KEY SOURCES OF ESTIMATION UNCERTINTY,0,0,0,0,0
3. INVESTMENT IN SUBSIDIARY,0,0,0,0,0
6. CASH AT BANK AND IN HAND,0,0,0,0,0
12. CONTROLLING PARTY,0,0,0,0,0
13. SUBSEQUENT EVENTS,0,0,0,0,0
"MÁSMÓVIL IBERCOM, S.A. AND SUBSIDIARIES",0,0,0,0,0
INDEPENDENT AUDITORS FOR THE GROUP KPMG LLP,0,0,0,0,0
FINANCIAL STATEMENTS,0,0,0,0,0
ANNEX—UNAUDITED COMBINED PRO FORMA FINANCIAL STATEMENTS,0,0,0,0,0
"ACT”), OR THE SECURITIES LAWS OF ANY STATE OF THE UNITED STATES OR OTHER JURISDICTION. THE",0,0,0,0,0
SHAREHOLDER,0,0,0,0,0
",** **, CONFIDENTIAL** **NOT FOR GENERAL DISTRIBUTION PRELIMINARY OFFERING MEMORANDUM** **IN THE UNITED STATES",0,0,0,0,0
IMPORTANT INFORMATION ABOUT THE OFFERING,0,0,0,0,0
OPERATING AND FINANCIAL REVIEW,0,0,0,0,0
CERTAIN INSOLVENCY AND LOCAL LAW LIMITATIONS,0,0,0,0,0
NOTES TO THE FINANCIAL STATEMENTS 1.** **GENERAL INFORMATION,0,0,0,0,0
2.** **BASIS OF PREPARATION,0,0,0,0,0
IFRS 3,0,0,0,0,0
IAS 37,0,0,0,0,0
5.** **CRITICAL JUDGEMENTS AND ESTIMATES,0,0,0,0,0
10.** **AUDITOR’S REMUNERATION,0,0,0,0,0
WORKING CAPITAL AND PROVISIONS,0,0,0,0,0
19.** **DISCONTINUED OPERATIONS,0,0,0,0,0
CAPITAL STRUCTURE AND FINANCING,0,0,0,0,0
24.** **PARTNER FINANCE BORROWINGS,0,0,0,0,0
PENSIONS AND OTHER INFORMATION 26.** **PENSIONS AND OTHER POST-RETIREMENT BENEFITS,0,0,0,0,0
28.** **SHARE BASED PAYMENTS,0,0,0,0,0
29.** **RELATED PARTY TRANSACTIONS AND DIRECTORS’ EMOLUMENTS,0,0,0,0,0
30.** **EVENTS AFTER THE REPORTING PERIOD,0,0,0,0,0
31.** **GROUP UNDERTAKINGS,0,0,0,0,0
RESULTS FOR THE PERIOD,0,0,0,0,0
8.** **EMPLOYEES AND DIRECTORS,0,0,0,0,0
10. AUDITOR’S REMUNERATION,0,0,0,0,0
LONG TERM ASSETS,0,0,0,0,0
23. PARTNER FINANCE BORROWINGS,0,0,0,0,0
PENSIONS AND OTHER INFORMATION 25. PENSIONS AND OTHER POST-RETIREMENT BENEFITS,0,0,0,0,0
27. RELATED PARTY TRANSACTIONS AND DIRECTORS EMOLUMENTS,0,0,0,0,0
28. EVENTS AFTER THE REPORTING PERIOD,0,0,0,0,0
29. LIST OF GROUP UNDERTAKINGS,0,0,0,0,0
LONG-TERM ASSETS,0,0,0,0,0
NOTES TO THE CONSOLIDATED FINANCIAL STATEMENTS 1.** **GENERAL INFORMATION,0,0,0,0,0
3.** **CRITICAL ACCOUNTING JUDGEMENTS AND ESTIMATES,0,0,0,0,0
"4.** **NEW STANDARDS, AMENDMENTS AND INTERPRETATIONS",0,0,0,0,0
6.** **INCOME TAX,0,0,0,0,0
12. PARTNER FINANCE BORROWINGS,0,0,0,0,0
"NOTICES TO INVESTORS THE SENIOR SECURED NOTES AND THE SENIOR NOTES MAY NOT BE OFFERED TO THE PUBLIC WITHIN ANY JURISDICTION. BY ACCEPTING DELIVERY OF THIS OFFERING MEMORANDUM, YOU AGREE NOT TO OFFER, SELL, RESELL, TRANSFER OR DELIVER, DIRECTLY OR INDIRECTLY, ANY NOTE TO THE PUBLIC. NOTICE TO U.S. INVESTORS",0,0,0,0,0
NOTICE TO INVESTORS IN THE GRAND DUCHY OF LUXEMBOURG,0,0,0,0,0
THE ISSUERS,0,0,0,0,0
DESCRIPTION OF THE FIXED RATE SENIOR SECURED NOTES,0,0,0,0,0
DESCRIPTION OF THE FLOATING RATE SENIOR SECURED NOTES,0,0,0,0,0
CERTAIN INSOLVENCY LAW CONSIDERATIONS LIMITATIONS ON VALIDITY AND ENFORCEABILITY OF THE GUARANTEES AND THE SECURITY INTERESTS,0,0,0,0,0
M&A,0,0,0,0,0
DESCRIPTION OF CERTAIN OTHER INDEBTEDNESS AND OTHER ARRANGEMENTS,0,0,0,0,0
"TRUSTEE AND SECURITY AGENT** **PAYING AGENT, TRANSFER AGENT, AND REGISTRAR",0,0,0,0,0
"IN CONNECTION WITH THIS ISSUE, DEUTSCHE BANK AG, LONDON BRANCH (THE ‘‘STABILIZING MANAGER’’) (OR PERSONS ACTING ON BEHALF OF THE STABILIZING MANAGER) MAY OVER-ALLOT OR EFFECT TRANSACTIONS WITH A VIEW TO SUPPORTING THE",0,0,0,0,0
THIS OFFERING MEMORANDUM CONTAINS IMPORTANT INFORMATION WHICH YOU SHOULD READ BEFORE YOU MAKE ANY DECISION WITH RESPECT TO AN INVESTMENT IN THE NOTES. USE OF TERMS AND CONVENTIONS,0,0,0,0,0
SUMMARY CONSOLIDATED FINANCIAL DATA,0,0,0,0,0
SHAREHOLDERS AND CERTAIN TRANSACTIONS,0,0,0,0,0
ERISA CONSIDERATIONS,0,0,0,0,0
"TOTAL . . . . . . . . . . . . . . . . . . . . . . . . . . . . . . . . . . . . . . . . . . . . . . . . . . . . . . . . . . . .** **534,125",0,0,0,0,0
"TOTAL . . . . . . . . . . . . . . . . . . . . . . . . . . . . . . . . . . . . . . . . . . . . . . . . . . . . . . . . . . . .** **413,311",0,0,0,0,0
"TOTAL . . . . . . . . . . . . . . . . . . . . . . . . . . . . . . . . . . . . . . . . . . . . . . . . . . . . . . . . . . . .** **534,685",0,0,0,0,0
BRAZIL,0,0,0,0,0
CHINA,0,0,0,0,0
INDIA,0,0,0,0,0
SOUTH KOREA,0,0,0,0,0
TURKEY,0,0,0,0,0
RUSSIA,0,0,0,0,0
LUXEMBOURG,0,0,0,0,0
OTHER,0,0,0,0,0
PROFIT BEFORE,0,0,0,0,0
PROFIT ATTRIBUTABLE TO,0,0,0,0,0
PROFIT FOR THE,0,0,0,0,0
2015 IMPACT ON PROFIT,0,0,0,0,0
2013 IMPACT ON PROFIT,0,0,0,0,0
2015 IMPACT ON EQUITY,0,0,0,0,0
2014 IMPACT ON EQUITY,0,0,0,0,0
PRELIMINARY OFFERING MEMORANDUM** **STRICTLY CONFIDENTIAL NOT FOR DISTRIBUTION IN THE UNITED STATES OR TO U.S. PERSONS,0,0,0,0,0
NOTICE TO CERTAIN INVESTORS IN LUXEMBOURG,0,0,0,0,0
CORPORATE STRUCTURE,0,0,0,0,0
DUFRY SUMMARY HISTORICAL CONSOLIDATED FINANCIAL AND OTHER DATA,0,0,0,0,0
DUFRY SELECTED HISTORICAL CONSOLIDATED FINANCIAL AND OTHER DATA,0,0,0,0,0
UK MIFIR PRODUCT GOVERNANCE/PROFESSIONAL INVESTORS AND ECPS ONLY TARGET,0,0,0,0,0
NOTICE TO CERTAIN INVESTORS IN THE UK,0,0,0,0,0
NOTICE TO CERTAIN INVESTORS IN ITALY,0,0,0,0,0
SUPPLY SHARE AND INDUSTRY INFORMATION,0,0,0,0,0
SUMMARY HISTORICAL FINANCIAL AND UNAUDITED PRO FORMA CONDENSED COMBINED FINANCIAL AND OTHER DATA,0,0,0,0,0
UNAUDITED PRO FORMA CONDENSED COMBINED FINANCIAL STATEMENTS,0,0,0,0,0
SELECTED CONSOLIDATED FINANCIAL DATA OF PQ HOLDINGS,0,0,0,0,0
SELECTED CONSOLIDATED FINANCIAL DATA OF ECO,0,0,0,0,0
MANAGEMENT’S DISCUSSION AND ANALYSIS OF FINANCIAL CONDITION AND RESULTS OF OPERATIONS OF PQ HOLDINGS,0,0,0,0,0
MANAGEMENT’S DISCUSSION AND ANALYSIS OF FINANCIAL CONDITION AND RESULTS OF OPERATIONS OF ECO,0,0,0,0,0
"O F F E R I N G** **M E M O R A N D U M , 2016",0,0,0,0,0
CERTAIN INSOLVENCY CONSIDERATIONS AND LIMITATIONS ON THE VALIDITY AND ENFORCEABILITY OF THE GUARANTEES AND THE SECURITY INTERESTS,0,0,0,0,0
MAXEDA DIY GROUP B.V.,0,0,0,0,0
REPORT ON THE OTHER INFORMATION INCLUDED IN THE ANNUAL ACCOUNTS,0,0,0,0,0
OFFERING MEMORANDUM** **NOT FOR GENERAL CIRCULATION IN THE UNITED STATES,0,0,0,0,0
PRESENTATION OF FINANCIAL AND NON-IFRS FINANCIAL MEASURES,0,0,0,0,0
SUMMARY HISTORICAL CONDENSED COMBINED FINANCIAL INFORMATION AND OTHER FINANCIAL DATA,0,0,0,0,0
II”);,0,0,0,0,0
MANAGER”) (OR PERSONS ACTING ON BEHALF OF THE STABILIZING MANAGER) MAY OVER-,0,0,0,0,0
RESTRICTION TERMINATION DATE”) WHICH IS ONE YEAR AFTER THE LATER OF THE,0,0,0,0,0
ANNEX A: SUMMARY OF CERTAIN DIFFERENCES BETWEEN ITALIAN GAAP AND IFRS,0,0,0,0,0
1.** **INTANGIBLE ASSETS,0,0,0,0,0
8.** **REVENUE RECOGNITION,0,0,0,0,0
11. PRESENTATION AND DISCLOSURE REQUIREMENTS,0,0,0,0,0
INDEX TO THE CONSOLIDATED FINANCIAL STATEMENTS,0,0,0,0,0
REGISTRAR,0,0,0,0,0
SUMMARY COMBINED FINANCIAL AND OTHER DATA OF THE ARDAGH CARVE-OUT BUSINESS,0,0,0,0,0
SUMMARY CONSOLIDATED FINANCIAL AND OTHER DATA OF EXAL,0,0,0,0,0
SUMMARY UNAUDITED PRO FORMA COMBINED FINANCIAL AND OTHER DATA,0,0,0,0,0
THE COMBINATION,0,0,0,0,0
SELECTED COMBINED FINANCIAL AND OTHER DATA OF THE ARDAGH CARVE-OUT BUSINESS,0,0,0,0,0
SELECTED CONSOLIDATED FINANCIAL AND OTHER DATA OF EXAL,0,0,0,0,0
OPERATING AND FINANCIAL REVIEW AND PROSPECTS OF THE ARDAGH CARVE-OUT BUSINESS,0,0,0,0,0
OPERATING AND FINANCIAL REVIEW AND PROSPECTS OF EXAL,0,0,0,0,0
THE TRIVIUM BUSINESS,0,0,0,0,0
FINANCIAL INFORMATION,0,0,0,0,0
"MARKET, RANKING, INDUSTRY DATA AND FORECASTS",0,0,0,0,0
"AMWINS GROUP, INC. AND SUBSIDIARIES (A WHOLLY OWNED SUBSIDIARY OF AMERICAN WHOLESALE INSURANCE HOLDING COMPANY, LLC) NOTES TO CONSOLIDATED FINANCIAL STATEMENTS (UNAUDITED)",0,0,0,0,0
STONEGATE GROUP’S SELECTED HISTORICAL CONSOLIDATED FINANCIAL INFORMATION,0,0,0,0,0
EI GROUP’S SELECTED HISTORICAL CONSOLIDATED FINANCIAL INFORMATION,0,0,0,0,0
STONEGATE GROUP MANAGEMENT’S DISCUSSION AND ANALYSIS OF FINANCIAL CONDITION AND RESULTS OF OPERATIONS,0,0,0,0,0
EI GROUP MANAGEMENT’S DISCUSSION AND ANALYSIS OF FINANCIAL CONDITION AND RESULTS OF OPERATIONS,0,0,0,0,0
LIMITATIONS ON VALIDITY AND ENFORCEABILITY OF THE NOTE GUARANTEES AND SECURITY INTERESTS,0,0,0,0,0
INDEPENDENT AUDITORS OF STONEGATE GROUP KPMG LLP,0,0,0,0,0
GLOSSARY OF KEY DEFINED TERMS,0,0,0,0,0
BUSINESS OVERVIEW OF HEATHROW AIRPORT,0,0,0,0,0
SUPPLIERS,0,0,0,0,0
SHARED SERVICES,0,0,0,0,0
PENSIONS,0,0,0,0,0
DIRECTORS AND SENIOR MANAGEMENT OF HEATHROW AIRPORT HOLDINGS BOARD OF DIRECTORS OF HEATHROW AIRPORT HOLDINGS,0,0,0,0,0
ISSUER FACILITIES,0,0,0,0,0
TERMS AND CONDITIONS OF THE NOTES IN DEFINITIVE FORM,0,0,0,0,0
2.** **STATUS,0,0,0,0,0
3.** **SECURITY,0,0,0,0,0
5.** **THE INTERCREDITOR AGREEMENT,0,0,0,0,0
6.** **INTEREST,0,0,0,0,0
11.** **EVENTS OF DEFAULT,0,0,0,0,0
12.** **ENFORCEMENT OF SECURITY,0,0,0,0,0
13.** **NOTEHOLDER ACTION,0,0,0,0,0
14.** **SUBSTITUTION,0,0,0,0,0
17.** **THE TRUSTEE,0,0,0,0,0
"18.** **NO PERSONAL LIABILITY OF DIRECTORS, OFFICERS, EMPLOYEES AND SHAREHOLDERS",0,0,0,0,0
19.** **FURTHER ISSUES,0,0,0,0,0
22.** **GOVERNING LAW,0,0,0,0,0
23.** **RIGHTS OF THIRD PARTIES,0,0,0,0,0
PROSPECTUS,0,0,0,0,0
SUMMARY HISTORICAL AND PRO FORMA CONDENSED CONSOLIDATED FINANCIAL DATA,0,0,0,0,0
UNAUDITED PRO FORMA CONDENSED CONSOLIDATED FINANCIAL DATA,0,0,0,0,0
SECURITY OWNERSHIP OF CERTAIN BENEFICIAL OWNERS AND MANAGEMENT,0,0,0,0,0
"THE SUMMARY OF U.S. FEDERAL INCOME TAX CONSEQUENCES SET OUT BELOW IS FOR GENERAL INFORMATION ONLY. ALL PROSPECTIVE PURCHASERS SHOULD CONSULT THEIR TAX ADVISERS AS TO THE PARTICULAR TAX CONSEQUENCES TO THEM OF ACQUIRING, OWNING, AND DISPOSING OF THE NOTES, INCLUDING THE APPLICABILITY AND EFFECT OF STATE, LOCAL, NON-U.S. AND OTHER TAX LAWS AND POSSIBLE CHANGES IN TAX LAW.",0,0,0,0,0
LIMITATIONS ON VALIDITY AND ENFORCEABILITY OF THE NOTES GUARANTEES AND THE SECURITY INTERESTS AND CERTAIN INSOLVENCY LAW CONSIDERATIONS,0,0,0,0,0
ASIA,0,0,0,0,0
OCEANIA,0,0,0,0,0
AFRICA,0,0,0,0,0
STATEMENT OF PROFIT OR LOSS AND OTHER COMPREHENSIVE INCOME,0,0,0,0,0
"STABILIZATION IN CONNECTION WITH THE OFFERING OF THE SECURITIES CREDIT SUISSE SECURITIES (USA) LLC (THE “USD NOTES STABILIZATION MANAGER”) AND MORGAN STANLEY & CO. INTERNATIONAL PLC (THE “NON-USD NOTES STABILIZATION MANAGER” AND TOGETHER WITH THE USD NOTES STABILIZATION MANAGER, THE “STABILIZATION MANAGERS”) (OR PERSONS ACTING ON THEIR RESPECTIVE BEHALF) MAY OVER ALLOT OR EFFECT TRANSACTIONS WITH A VIEW TO SUPPORTING THE MARKET PRICE OF THE RESPECTIVE SERIES OF NOTES AT A LEVEL OTHER THAN THAT WHICH MIGHT OTHERWISE PREVAIL.",0,0,0,0,0
NON-GAAP AND NON-IFRS FINANCIAL MEASURES,0,0,0,0,0
CDPQ,0,0,0,0,0
SUMMARY HISTORICAL CONSOLIDATED AND PRO FORMA COMBINED FINANCIAL INFORMATION,0,0,0,0,0
SUMMARY HISTORICAL CONSOLIDATED FINANCIAL INFORMATION OF G4S,0,0,0,0,0
CERTAIN UNITED KINGDOM TAX CONSIDERATIONS,0,0,0,0,0
LIABILITIES AND MEMBER'S CAPITAL,0,0,0,0,0
NONCASH INVESTING AND FINANCING ACTIVITIES:,0,0,0,0,0
IV** **- CONSOLIDATED STATEMENT OF CHANGES IN EQUITY,0,0,0,0,0
NOTE 9.** **LITIGATION AND CONTINGENT LIABILITIES,0,0,0,0,0
NOTE 10. SUBSEQUENT EVENTS,0,0,0,0,0
NOTE 11. FEES PAID TO STATUTORY AUDITORS,0,0,0,0,0
NOTE 12. LIST OF CONSOLIDATED COMPANIES,0,0,0,0,0
FONCIA MANAGEMENT,0,0,0,0,0
CO-COUNSEL TO EACH ISSUER,0,0,0,0,0
P R E L I M I N A R Y** **O F F E R I N G** **M E M O R A N D U M** **C O N F I D E N T I A L,0,0,0,0,0
NON-GAAP FINANCIAL INFORMATION,0,0,0,0,0
EMEA,0,0,0,0,0
"CROCS, INC. AND SUBSIDIARIES NOTES TO CONSOLIDATED FINANCIAL STATEMENTS 1.** **BASIS OF PRESENTATION AND SUMMARY OF SIGNIFICANT ACCOUNTING POLICIES",0,0,0,0,0
"3.** **PROPERTY AND EQUIPMENT, NET",0,0,0,0,0
"4.** **GOODWILL AND INTANGIBLE ASSETS, NET",0,0,0,0,0
5.** **ACCRUED EXPENSES AND OTHER LIABILITIES,0,0,0,0,0
6.** **LEASES,0,0,0,0,0
7.** **FAIR VALUE MEASUREMENTS,0,0,0,0,0
8.** **DERIVATIVE FINANCIAL INSTRUMENTS,0,0,0,0,0
9.** **REVOLVING CREDIT FACILITY AND BANK BORROWINGS,0,0,0,0,0
11.** **REVENUES,0,0,0,0,0
12.** **SHARE-BASED COMPENSATION,0,0,0,0,0
14.** **EARNINGS PER SHARE,0,0,0,0,0
16.** **OPERATING SEGMENTS AND GEOGRAPHIC INFORMATION,0,0,0,0,0
17.** **LEGAL PROCEEDINGS,0,0,0,0,0
18.** **EMPLOYEE BENEFIT PLAN,0,0,0,0,0
"PRELIMINARY OFFERING MEMORANDUM , 2021",0,0,0,0,0
USE OF UNAUDITED PRO FORMA CONDENSED CONSOLIDATED FINANCIAL INFORMATION,0,0,0,0,0
SERVICE OF PROCESS AND ENFORCEABILITY OF CERTAIN CIVIL LIABILITIES,0,0,0,0,0
O F F E R I N G  M E M O R A N D U M,0,0,0,0,0
REGULATION”) FROM THE REQUIREMENT TO PUBLISH A PROSPECTUS FOR OFFERS OF NOTES.,0,0,0,0,0
DEFINITIONS AND CURRENCY PRESENTATION,0,0,0,0,0
DESCRIPTION OF THE INTERCREDITOR AGREEMENT,0,0,0,0,0
DESCRIPTION OF THE COLLATERAL SHARING AGREEMENT,0,0,0,0,0
DESCRIPTION OF THE UPC CREDIT FACILITY AND THE RELATED AGREEMENTS,0,0,0,0,0
"INVESTOR”) OR (IV) A GOVERNMENTAL, CHURCH OR NON-U.S. PLAN WHICH IS",0,0,0,0,0
CERTAIN DUTCH TAX CONSIDERATIONS,0,0,0,0,0
ANNEX A: UPC CREDIT FACILITY,0,0,0,0,0
THE FINANCIAL INSTITUTIONS LISTED HEREIN,0,0,0,0,0
THE BANK OF NOVA SCOTIA,0,0,0,0,0
SENIOR SECURED CREDIT FACILITY AGREEMENT,0,0,0,0,0
UPC BROADBAND HOLDING B.V.,0,0,0,0,0
18.15 ERISA,0,0,0,0,0
19.25 ERISA,0,0,0,0,0
23.4** **VAT,0,0,0,0,0
29.** **DISCLOSURE OF INFORMATION,0,0,0,0,0
33.** **SEVERABILITY,0,0,0,0,0
34.** **COUNTERPARTS,0,0,0,0,0
36.** **LANGUAGE,0,0,0,0,0
38.** **WAIVER OF IMMUNITY,0,0,0,0,0
39.** **WAIVER OF TRIAL BY JURY,0,0,0,0,0
40.** **GOVERNING LAW,0,0,0,0,0
ANNEX 1,0,0,0,0,0
SCHEDULE 6 FORM OF L/C BANK ACCESSION CERTIFICATE,0,0,0,0,0
6.** **UCP,0,0,0,0,0
SCHEDULE FORM OF DEMAND,0,0,0,0,0
SCHEDULE 8 FORM OF INCREASE CONFIRMATION,0,0,0,0,0
SCHEDULE 9 FORM OF DESIGNATED ENTITY ACCESSION AGREEMENT,0,0,0,0,0
SCHEDULE 11 AGREED SECURITY PRINCIPLES,0,0,0,0,0
SIGNATORIES UPC BROADBAND UPC BROADBAND HOLDING B.V.,0,0,0,0,0
OBLIGORS’ AGENT UPC BROADBAND HOLDING B.V.,0,0,0,0,0
FACILITY AGENT THE BANK OF NOVA SCOTIA,0,0,0,0,0
SECURITY AGENT THE BANK OF NOVA SCOTIA,0,0,0,0,0
THE REVOLVING FACILITY LENDERS HSBC BANK PLC,0,0,0,0,0
BARCLAYS BANK PLC,0,0,0,0,0
"DEUTSCHE BANK AG, LONDON BRANCH",0,0,0,0,0
THE ROYAL BANK OF SCOTLAND PLC,0,0,0,0,0
CREDIT AGRICOLE CORPORATE AND INVESTMENT BANK,0,0,0,0,0
ING BANK N.V.,0,0,0,0,0
BNP PARIBAS FORTIS SA/NV,0,0,0,0,0
GOLDMAN SACHS BANK USA,0,0,0,0,0
SCOTIABANK EUROPE PLC,0,0,0,0,0
"CREDIT SUISSE AG, LONDON BRANCH",0,0,0,0,0
"BANK OF AMERICA, N.A., LONDON BRANCH",0,0,0,0,0
"MORGAN STANLEY BANK, N.A.",0,0,0,0,0
"JPMORGAN CHASE BANK, N.A. – LONDON BRANCH",0,0,0,0,0
"SOCIETE GENERALE, LONDON BRANCH",0,0,0,0,0
"CITIBANK N.A., LONDON BRANCH",0,0,0,0,0
ANNEX B: FORM OF NEW FINCO FACILITY DEED OF COVENANT,0,0,0,0,0
UPC FINANCING PARTNERSHIP,0,0,0,0,0
UPC BROADBAND FINCO B.V.,0,0,0,0,0
3.** **COMPANY’S AND THE UPC CREDIT FACILITY BORROWER’S LIABILITY,0,0,0,0,0
ANNEX C: FORM OF NEW FINCO FACILITY ACCESSION AGREEMENT,0,0,0,0,0
PROJECT WEISSHORN $[Š] ADDITIONAL FACILITY AZ ACCESSION AGREEMENT,0,0,0,0,0
SCHEDULE 4 [INTENTIONALLY LEFT BLANK],0,0,0,0,0
SCHEDULE 5 [INTENTIONALLY LEFT BLANK],0,0,0,0,0
"SCHEDULE 6 ADDITIONAL AMENDMENTS, WAIVERS, CONSENTS AND OTHER MODIFICATIONS",0,0,0,0,0
"SCHEDULE 7 FOURTH AMENDMENTS, WAIVERS, CONSENTS AND OTHER MODIFICATIONS [INTENTIONALLY LEFT BLANK]",0,0,0,0,0
"SCHEDULE 8 FIFTH AMENDMENTS, WAIVERS, CONSENTS AND OTHER MODIFICATIONS",0,0,0,0,0
"SCHEDULE 9 SIXTH AMENDMENTS, WAIVERS, CONSENTS AND OTHER MODIFICATIONS",0,0,0,0,0
"SCHEDULE 10 SEVENTH AMENDMENTS, WAIVERS, CONSENTS AND OTHER MODIFICATIONS",0,0,0,0,0
"SCHEDULE 11 EIGHTH AMENDMENTS, WAIVERS, CONSENTS AND OTHER MODIFICATIONS",0,0,0,0,0
"SCHEDULE 12 NINTH AMENDMENTS, WAIVERS, CONSENTS AND OTHER MODIFICATIONS",0,0,0,0,0
LEGAL ADVISERS TO THE ISSUER AND THE UPC HOLDING GROUP,0,0,0,0,0
INDEPENDENT AUDITORS FOR THE UPC** **HISTORIC INDEPENDENT AUDITORS FOR HOLDING GROUP** **SUNRISE COMMUNICATIONS KPMG LLP,0,0,0,0,0
"TRUSTEE, PAYING AGENT, REGISTRAR AND TRANSFER AGENT",0,0,0,0,0
OUR HISTORY,0,0,0,0,0
OUR GEOGRAPHIES,0,0,0,0,0
OUR PRODUCTS,0,0,0,0,0
OUR OPERATIONS,0,0,0,0,0
OUR DIVERSE END-USE SEGMENTS AND COMPETITIVE LANDSCAPE,0,0,0,0,0
OUR BUSINESS STRATEGY,0,0,0,0,0
MATERIAL U.S. FEDERAL INCOME TAX CONSEQUENCES,0,0,0,0,0
INDEPENDENT AUDITORS' REPORT,0,0,0,0,0
GAAP”);,0,0,0,0,0
ADJ. EBITDA (€M)[(*)],0,0,0,0,0
"ONLINE UNIVERSITIES ARE CONSIDERED AS SIMILAR, IF NOT** **MORE FLEXIBILITY, TIME SAVING,AND A PERCEIVED FASTER** **ONLINE UNIVERSITIES SHOW COMPARABLE EMPLOYABILITY TO BETTER, THAN TRADITIONAL ONES FOR QUALITY OF TEACHING** **CAREER PATH ARE KEY ATTRACTION POINTS FOR ONLINE** **MID-SIZED UNIVERSITIES, BEHIND ONLY LARGE-SIZED",0,0,0,0,0
SUMMARY CORPORATE AND FINANCING STRUCTURE—ON AND IMMEDIATELY FOLLOWING THE ISSUE DATE BUT PRIOR TO THE POST-CLOSING REORGANISATION,0,0,0,0,0
PERSONS RESPONSIBLE FOR THE INFORMATION GIVEN IN THE PROSPECTUS,0,0,0,0,0
CROSS-REFERENCE LIST,0,0,0,0,0
FISCAL AGENT AND PRINCIPAL PAYING AGENT,0,0,0,0,0
LUXEMBOURG PAYING AGENT,0,0,0,0,0
PUT AGENT,0,0,0,0,0
GLOBAL LEADER IN CABLES,0,0,0,0,0
MESSAGE FROM THE CHAIRMAN,0,0,0,0,0
CORPORATE GOVERNANCE,0,0,0,0,0
HIGHLIGHTS,0,0,0,0,0
GROWTH,0,0,0,0,0
INNOVATION,0,0,0,0,0
HUMAN RESOURCES,0,0,0,0,0
FINANCE,0,0,0,0,0
THE NEXANS SHARE,0,0,0,0,0
SHAREHOLDER INFORMATION AND SERVICES,0,0,0,0,0
TELECOM CABLES,0,0,0,0,0
ELECTRICAL WIRES,0,0,0,0,0
OUR IMPROVEMENTS IN 2006 PROGRESS AND COMMITMENTS,0,0,0,0,0
UNDERSTAND AND SATISFY OUR CUSTOMERS,0,0,0,0,0
BOOST OUR EFFICIENCY,0,0,0,0,0
2006 CONSOLIDATED FINANCIAL STATEMENTS,0,0,0,0,0
TABLE OF CONTENTS BALANCE SHEET,0,0,0,0,0
NOTES,0,0,0,0,0
NOTES TO THE BALANCE SHEET,0,0,0,0,0
NOTES TO THE INCOME STATEMENT,0,0,0,0,0
MISCELLANEOUS INFORMATION,0,0,0,0,0
RECEIVABLES,0,0,0,0,0
MISCELLANEOUS,0,0,0,0,0
ACCRUALS,0,0,0,0,0
BALANCE SHEET – EQUITY AND LIABILITIES,0,0,0,0,0
INCOME STATEMENT ITEMS,0,0,0,0,0
INFORMATION ON THE COMPANY’S CAPITAL AND VOTING RIGHTS,0,0,0,0,0
AUDITORS OF NEXANS,0,0,0,0,0
RECENT DEVELOPMENTS,0,0,0,0,0
NOTICE TO KOREAN INVESTORS,0,0,0,0,0
NOTICE TO MEXICAN INVESTORS,0,0,0,0,0
SELECTED HISTORICAL FINANCIAL INFORMATION AND OTHER DATA,0,0,0,0,0
SSRCF,0,0,0,0,0
INDEPENDENT AUDITOR'S REVIEW REPORT,0,0,0,0,0
REGISTERED OFFICE OF THE ISSUERS,0,0,0,0,0
LEGAL ADVISORS TO THE TARGET,0,0,0,0,0
"TRADEMARKS, COPYRIGHTS AND TRADE NAMES",0,0,0,0,0
"THE UNITED STATES FEDERAL INCOME TAX DISCUSSION SET FORTH ABOVE IS INCLUDED FOR GENERAL INFORMATION ONLY AND MAY NOT BE APPLICABLE DEPENDING UPON A HOLDER’S PARTICULAR SITUATION. PROSPECTIVE HOLDERS OF THE NOTES SHOULD CONSULT THEIR TAX ADVISORS WITH RESPECT TO THE TAX CONSEQUENCES TO THEM OF THE ACQUISITION, OWNERSHIP AND DISPOSITION OF NOTES, INCLUDING THE TAX CONSEQUENCES UNDER UNITED STATES FEDERAL, STATE, LOCAL, NON-UNITED STATES AND OTHER TAX LAWS AND TAX TREATIES AND THE POSSIBLE EFFECTS OF CHANGES IN UNITED STATES OR OTHER TAX LAWS.",0,0,0,0,0
LIABILITIES AND PARTNERS’ EQUITY,0,0,0,0,0
STATE”) OF THE EUROPEAN ECONOMIC AREA (“EEA”) OR IN THE UNITED KINGDOM (THE,0,0,0,0,0
PRELIMINARY OFFERING MEMORANDUM** **STRICTLY CONFIDENTIAL NOT FOR GENERAL DISTRIBUTION IN THE UNITED STATES,0,0,0,0,0
"MANAGER”) (OR PERSONS ACTING ON ITS BEHALF), MAY OVER-ALLOT NOTES OR EFFECT",0,0,0,0,0
ITALIAN “WHITE LIST”,0,0,0,0,0
EOLO’S END TO END INFRASTRUCTURE NETWORK,0,0,0,0,0
FWA NETWORK COVERAGE BY REGION AS** **FWA NETWORK COVERAGE BY REGION AS PERCENTAGE OF HOUSEHOLDS** **NUMBER OF ACTIVE BTS,0,0,0,0,0
FWA NETWORK COVERAGE BY REGION AS** **FWA NETWORK COVERAGE BY REGION PERCENTAGE OF HOUSEHOLDS** **AS NUMBER OF ACTIVE BTS,0,0,0,0,0
EOLO,0,0,0,0,0
PRESENTATION OF INFORMATION,0,0,0,0,0
"TRADEMARKS, TRADE NAMES AND SERVICE MARKS",0,0,0,0,0
NOTICE TO INVESTORS IN JERSEY,0,0,0,0,0
NOTICE TO INVESTORS IN AUSTRALIA,0,0,0,0,0
DESCRIPTION OF OTHER INDEBTEDNESS AND FINANCING ARRANGEMENTS,0,0,0,0,0
B,0,0,0,0,0
"SYNEOS HEALTH, INC. AND SUBSIDIARIES CONDENSED CONSOLIDATED STATEMENTS OF OPERATIONS",0,0,0,0,0
"SYNEOS HEALTH, INC. AND SUBSIDIARIES CONDENSED CONSOLIDATED STATEMENTS OF COMPREHENSIVE INCOME (LOSS)",0,0,0,0,0
"SYNEOS HEALTH, INC. AND SUBSIDIARIES CONDENSED CONSOLIDATED BALANCE SHEETS",0,0,0,0,0
"SYNEOS HEALTH, INC. AND SUBSIDIARIES CONDENSED CONSOLIDATED STATEMENTS OF CASH FLOWS",0,0,0,0,0
"SYNEOS HEALTH, INC. AND SUBSIDIARIES CONDENSED CONSOLIDATED STATEMENTS OF SHAREHOLDERS’ EQUITY",0,0,0,0,0
"SYNEOS HEALTH, INC. AND SUBSIDIARIES NOTES TO CONDENSED CONSOLIDATED FINANCIAL STATEMENTS",0,0,0,0,0
O F F E R I N G  CIRCULAR,0,0,0,0,0
STABILIZATION OF THE SENIOR SECURED NOTES,0,0,0,0,0
STABILIZATION OF THE SENIOR NOTES,0,0,0,0,0
MIFID II PRODUCT GOVERNANCE / PROFESSIONAL INVESTORS AND ELIGIBLE COUNTERPARTIES ONLY TARGET MARKET,0,0,0,0,0
UK MIFIR PRODUCT GOVERNANCE / PROFESSIONAL INVESTORS AND ELIGIBLE COUNTERPARTIES ONLY TARGET MARKET,0,0,0,0,0
NOTES TO THE UNAUDITED CONDENSED CONSOLIDATED INTERIM FINANCIAL STATEMENTS 1** **BASIS OF PREPARATION GENERAL,0,0,0,0,0
CHANGES IN THE COMPOSITION OF THE ENTITY,0,0,0,0,0
CHANGES IN ACCOUNTING POLICIES AND DISCLOSURES,0,0,0,0,0
"STANDARDS, AMENDMENTS AND INTERPRETATIONS ADOPTED BY THE GROUP",0,0,0,0,0
USE OF JUDGEMENTS AND ESTIMATES,0,0,0,0,0
2** **NET REVENUE AND SEGMENT INFORMATION,0,0,0,0,0
4** **INVENTORIES,0,0,0,0,0
"5** **PROPERTY, PLANT AND EQUIPMENT",0,0,0,0,0
6** **RIGHT-OF-USE ASSETS,0,0,0,0,0
7** **INTANGIBLE ASSETS,0,0,0,0,0
9** **FINANCIAL LIABILITIES AND LEASE LIABILITIES FINANCIAL LIABILITIES,0,0,0,0,0
LEASE LIABILITIES,0,0,0,0,0
OTHER PROVISIONS,0,0,0,0,0
11** **INCOME TAXES,0,0,0,0,0
12** **FINANCIAL INSTRUMENTS AND RISK MANAGEMENT,0,0,0,0,0
INTEREST RATE RISK MANAGEMENT,0,0,0,0,0
FINANCIAL INSTRUMENTS MEASURED AT FAIR VALUE,0,0,0,0,0
13** **COMMITMENTS AND CONTINGENCIES CONTINGENT LIABILITIES,0,0,0,0,0
BANK GUARANTEES,0,0,0,0,0
OTHER COMMITMENTS,0,0,0,0,0
14** **RELATED PARTY DISCLOSURES TRANSACTIONS WITH RELATED PARTIES,0,0,0,0,0
OUTSTANDING BALANCES ARISING FROM SALES/PURCHASES OF GOODS AND SERVICES,0,0,0,0,0
T-MOBILE NETHERLANDS HOLDING B.V. THE HAGUE CONSOLIDATED FINANCIAL STATEMENTS 2020,0,0,0,0,0
1.2** **GROUP INFORMATION,0,0,0,0,0
1.3** **ACQUISITION OF SIMPEL,0,0,0,0,0
2.2** **CHANGES IN ACCOUNTING POLICIES AND DISCLOSURES,0,0,0,0,0
2.3** **COMPARATIVE FIGURES,0,0,0,0,0
"2.4** **STANDARDS, AMENDMENTS AND INTERPRETATIONS ADOPTED BY THE GROUP",0,0,0,0,0
2.6** **BUSINESS COMBINATIONS,0,0,0,0,0
"2.7.2 TRANSACTIONS, RECEIVABLES AND DEBTS",0,0,0,0,0
2.8** **GOING CONCERN,0,0,0,0,0
2.10** **SEGMENT REPORTING,0,0,0,0,0
2.11** **JUDGEMENTS AND ESTIMATES,0,0,0,0,0
"2.11.1 IMPAIRMENTS OF PROPERTY, PLANT AND EQUIPMENT AND INTANGIBLE ASSETS",0,0,0,0,0
2.11.2 DEPRECIATION AND AMORTIZATION OF NON-CURRENT ASSETS,0,0,0,0,0
2.11.3 DETERMINATION OF THE CASH GENERATING UNITS AND THE RECOVERABLE AMOUNT OF A CASH-GENERATING UNIT,0,0,0,0,0
2.11.4 IMPAIRMENT OF TRADE RECEIVABLES AND CONTRACT ASSETS,0,0,0,0,0
2.11.5 BUSINESS COMBINATION,0,0,0,0,0
2.11.6 SHARE-BASED PAYMENTS,0,0,0,0,0
2.12** **JUDGEMENTS IN APPLYING ACCOUNTING POLICIES,0,0,0,0,0
2.12.1 JUDGEMENT IN THE CLASSIFICATION OF CASH AND CASH EQUIVALENTS,0,0,0,0,0
2.12.2 JUDGEMENTS FOR THE RECOVERABILITY OF CURRENT AND DEFERRED TAXES,0,0,0,0,0
2.12.3 JUDGEMENT IN MEASURING AND RECOGNIZING PROVISIONS AND CONTINGENT LIABILITIES,0,0,0,0,0
"2.12.5** **JUDGEMENT:** **REVENUE** **RECOGNITION,** **CONTRACT** **ASSETS** **AND** **LIABILITIES/ CONTRACT COSTS",0,0,0,0,0
2.12.6 JUDGEMENTS: EXTENSION AND TERMINATION OPTIONS FOR THE LESSEE,0,0,0,0,0
2.13** **SUMMARY OF ACCOUNTING POLICIES,0,0,0,0,0
2.13.1 INTANGIBLE ASSETS (EXCLUDING GOODWILL),0,0,0,0,0
2.13.2 GOODWILL,0,0,0,0,0
"2.13.3 PROPERTY, PLANT AND EQUIPMENT",0,0,0,0,0
2.13.4 BORROWING COSTS,0,0,0,0,0
"2.13.5 IMPAIRMENTS OF INTANGIBLE ASSETS (INCLUDING GOODWILL) AND ITEMS OF PROPERTY, PLANT AND EQUIPMENT AND RIGHT-OF-USE ASSETS",0,0,0,0,0
2.13.6 INVENTORIES,0,0,0,0,0
2.13.7 PROVISIONS FOR PENSIONS AND OTHER EMPLOYEE BENEFITS,0,0,0,0,0
2.13.8 OTHER PROVISIONS,0,0,0,0,0
2.13.9 FINANCIAL INSTRUMENTS,0,0,0,0,0
2.13.12 CONTINGENCIES (CONTINGENT ASSETS AND LIABILITIES),0,0,0,0,0
2.13.13 LEASES,0,0,0,0,0
"2.13.15 NET REVENUE, CONTRACT ASSETS, CONTRACT LIABILITIES AND CAPITALIZED CONTRACT COSTS",0,0,0,0,0
2.13.17 INCOME TAXES,0,0,0,0,0
8.** **INTANGIBLE ASSETS,0,0,0,0,0
OTHER INTANGIBLES,0,0,0,0,0
ASSETS UNDER CONSTRUCTION,0,0,0,0,0
"9.** **PROPERTY, PLANT AND EQUIPMENT",0,0,0,0,0
10. RIGHT-OF-USE ASSETS,0,0,0,0,0
11.** **CAPITALIZED CONTRACT COSTS,0,0,0,0,0
15.** **CONTRACT LIABILITIES,0,0,0,0,0
ASSET RETIREMENT OBLIGATION (ARO),0,0,0,0,0
17.** **SHAREHOLDERS’ EQUITY,0,0,0,0,0
18.** **NET REVENUE AND SEGMENT INFORMATION,0,0,0,0,0
20.** **OWN CAPITALIZED COSTS,0,0,0,0,0
28.** **INCOME TAXES INCOME TAXES IN THE CONSOLIDATED INCOME STATEMENT,0,0,0,0,0
31.** **EARNINGS PER SHARE,0,0,0,0,0
32.** **FINANCIAL INSTRUMENTS AND RISK MANAGEMENT,0,0,0,0,0
OBJECTIVES AND POLICIES,0,0,0,0,0
FOREIGN CURRENCY RISK MANAGEMENT,0,0,0,0,0
DISCLOSURES ON FAIR VALUE,0,0,0,0,0
TRANSFER OF ASSETS (FACTORING OF RECEIVABLES),0,0,0,0,0
FINANCIAL COVENANTS,0,0,0,0,0
35.** **SUBSEQUENT EVENTS,0,0,0,0,0
T-MOBILE NETHERLANDS HOLDING B.V. THE HAGUE CONSOLIDATED FINANCIAL STATEMENTS 2019,0,0,0,0,0
CONTENTS CONSOLIDATED FINANCIAL STATEMENTS,0,0,0,0,0
1.2.1 CHANGES IN THE COMPOSITION OF THE GROUP,0,0,0,0,0
ACQUISITION OF TELE2 NETHERLANDS HOLDING N.V.,0,0,0,0,0
1.2.2 DISTRIBUTION OF T-MOBILE INFRA B.V. TO OWNERS BY DIVIDEND IN KIND,0,0,0,0,0
"2.4** **NEW STANDARDS, AMENDMENTS AND INTERPRETATIONS ADOPTED BY THE GROUP",0,0,0,0,0
2.5.2 BUSINESS COMBINATIONS,0,0,0,0,0
"2.6.2 TRANSACTIONS, RECEIVABLES AND DEBTS",0,0,0,0,0
2.7** **GOING CONCERN,0,0,0,0,0
2.9** **SEGMENT REPORTING,0,0,0,0,0
2.10** **JUDGEMENTS AND ESTIMATES,0,0,0,0,0
"2.10.1 IMPAIRMENTS OF PROPERTY, PLANT AND EQUIPMENT AND INTANGIBLE ASSETS",0,0,0,0,0
2.10.2 DEPRECIATION AND AMORTIZATION OF NON-CURRENT ASSETS,0,0,0,0,0
2.10.3 DETERMINATION OF THE RECOVERABLE AMOUNT OF A CASH-GENERATING UNIT,0,0,0,0,0
2.10.5 BUSINESS COMBINATION,0,0,0,0,0
2.10.6 SHARE BASED PAYMENTS,0,0,0,0,0
2.11** **JUDGMENTS IN APPLYING ACCOUNTING POLICIES,0,0,0,0,0
2.11.1 JUDGMENT IN THE CLASSIFICATION OF CASH AND CASH EQUIVALENTS,0,0,0,0,0
2.11.2 JUDGMENTS FOR THE RECOVERABILITY OF CURRENT AND DEFERRED TAXES,0,0,0,0,0
2.11.3 JUDGMENT IN MEASURING AND RECOGNIZING PROVISIONS AND CONTINGENT LIABILITIES,0,0,0,0,0
"2.11.5** **JUDGMENT:** **REVENUE** **RECOGNITION,** **CONTRACT** **ASSETS** **AND** **LIABILITIES/ CONTRACT COSTS",0,0,0,0,0
2.11.6 JUDGMENTS: EXTENSION AND TERMINATION OPTIONS FOR THE LESSEE,0,0,0,0,0
2.12** **SUMMARY OF ACCOUNTING POLICIES,0,0,0,0,0
2.12.1 INTANGIBLE ASSETS (EXCLUDING GOODWILL),0,0,0,0,0
2.12.2 GOODWILL,0,0,0,0,0
"2.12.3 PROPERTY, PLANT AND EQUIPMENT",0,0,0,0,0
2.12.4 BORROWING COSTS,0,0,0,0,0
"2.12.5 IMPAIRMENTS OF INTANGIBLE ASSETS (INCLUDING GOODWILL) AND ITEMS OF PROPERTY, PLANT AND EQUIPMENT AND RIGHT-OF-USE ASSETS",0,0,0,0,0
2.12.6 INVENTORIES,0,0,0,0,0
2.12.7 ASSETS CLASSIFIED AS HELD FOR DISTRIBUTION TO OWNERS,0,0,0,0,0
2.12.8 PROVISIONS FOR PENSIONS AND OTHER EMPLOYEE BENEFITS,0,0,0,0,0
2.12.9 OTHER PROVISIONS,0,0,0,0,0
2.12.10 FINANCIAL INSTRUMENTS,0,0,0,0,0
2.12.13 CONTINGENCIES (CONTINGENT LIABILITIES AND ASSETS),0,0,0,0,0
2.12.14 LEASES,0,0,0,0,0
"2.12.16 NET REVENUE, CONTRACT ASSETS, CONTRACT LIABILITIES AND CAPITALIZED CONTRACT COSTS",0,0,0,0,0
2.12.18 INCOME TAXES,0,0,0,0,0
"3.** **STANDARDS, INTERPRETATIONS, AND AMENDMENTS ISSUED, BUT NOT YET TO BE APPLIED",0,0,0,0,0
10.** **INTANGIBLE ASSETS,0,0,0,0,0
"11.** **PROPERTY, PLANT AND EQUIPMENT",0,0,0,0,0
12.** **RIGHT-OF-USE ASSETS,0,0,0,0,0
17.** **CONTRACT LIABILITIES,0,0,0,0,0
19.** **SHAREHOLDER’S EQUITY,0,0,0,0,0
20.** **NET REVENUE AND SEGMENT INFORMATION,0,0,0,0,0
25.** **KEY MANAGEMENT REMUNERATION,0,0,0,0,0
31.** **CONTINGENCIES CONTINGENT LIABILITIES,0,0,0,0,0
33.** **EARNINGS PER SHARE,0,0,0,0,0
34.** **FINANCIAL INSTRUMENTS AND RISK MANAGEMENT,0,0,0,0,0
35.2** **OUTSTANDING BALANCES ARISING FROM SALES/PURCHASES OF GOODS AND SERVICES,0,0,0,0,0
36.** **INDEPENDENT AUDITOR’S FEE,0,0,0,0,0
37.1** **ACQUISITION OF SIMPEL.NL B.V.,0,0,0,0,0
"EUR’1,000,000",0,0,0,0,0
"IN MAKING YOUR INVESTMENT DECISION, YOU SHOULD RELY ONLY ON THE INFORMATION CONTAINED IN THIS OFFERING MEMORANDUM. NEITHER THE COMPANY, ANY OF ITS SUBSIDIARIES (INCLUDING THE ISSUER) NOR THE INITIAL PURCHASERS HAVE AUTHORIZED ANYONE TO PROVIDE YOU WITH DIFFERENT INFORMATION. IF YOU RECEIVE ANY OTHER INFORMATION, YOU SHOULD NOT RELY ON IT. NEITHER THE ISSUER, THE GUARANTORS NOR ANY OF THE INITIAL PURCHASERS IS MAKING AN OFFER OF THE NOTES IN ANY JURISDICTION WHERE THE OFFERING IS NOT PERMITTED. YOU SHOULD NOT ASSUME THAT THE INFORMATION CONTAINED IN THIS OFFERING MEMORANDUM IS ACCURATE AS OF ANY DATE OTHER THAN THE DATE ON THE FRONT OF THIS OFFERING MEMORANDUM. OUR BUSINESS AND FINANCIAL CONDITION AND OTHER INFORMATION IN THIS OFFERING MEMORANDUM MAY CHANGE AFTER THAT DATE.",0,0,0,0,0
NOTICE TO IRISH INVESTORS,0,0,0,0,0
NOTICE TO AUSTRALIAN INVESTORS,0,0,0,0,0
MARKET AND INDUSTRY INFORMATION,0,0,0,0,0
SUMMARY FINANCIAL INFORMATION,0,0,0,0,0
U.S.,0,0,0,0,0
THE DISCUSSION ABOVE IS A GENERAL SUMMARY. IT DOES NOT COVER ALL TAX MATTERS THAT MAY BE IMPORTANT TO A PARTICULAR INVESTOR. EACH PROSPECTIVE INVESTOR SHOULD CONSULT ITS TAX ADVISOR ABOUT THE TAX CONSEQUENCES TO IT OF AN INVESTMENT IN THE NOTES.,0,0,0,0,0
"ACT”), OR THE SECURITIES LAWS OF ANY STATE OF THE UNITED STATES",0,0,0,0,0
INSTITUTIONAL BUYER” (AS DEFINED IN RULE 144A UNDER THE U.S.,0,0,0,0,0
"TRANSACTION,” “UNITED STATES,” AND “U.S. PERSON” HAVE THE",0,0,0,0,0
FLUTTER ENTERTAINMENT PLC CONSOLIDATED BALANCE SHEETS,0,0,0,0,0
FLUTTER ENTERTAINMENT PLC CONSOLIDATED STATEMENTS OF COMPREHENSIVE (LOSS),0,0,0,0,0
FLUTTER ENTERTAINMENT PLC CONSOLIDATED STATEMENTS OF CHANGES IN SHAREHOLDERS’ EQUITY AND REDEEMABLE NON-CONTROLLING INTERESTS,0,0,0,0,0
FLUTTER ENTERTAINMENT PLC CONSOLIDATED STATEMENTS OF CASH FLOWS,0,0,0,0,0
NON-CASH INVESTING AND FINANCING ACTIVITIES:,0,0,0,0,0
FLUTTER ENTERTAINMENT PLC NOTES TO THE CONSOLIDATED FINANCIAL STATEMENTS 1.** **ORGANIZATION AND DESCRIPTION OF BUSINESS,0,0,0,0,0
3.** **SEGMENTS AND DISAGGREGATION OF REVENUE,0,0,0,0,0
"4.** **OTHER (EXPENSE) INCOME, NET",0,0,0,0,0
7.** **LOSS PER SHARE,0,0,0,0,0
8.** **PREPAID EXPENSES AND OTHER CURRENT ASSETS,0,0,0,0,0
"11.** **INTANGIBLE ASSETS, NET",0,0,0,0,0
13.** **OTHER CURRENT LIABILITIES,0,0,0,0,0
14.** **LEASES,0,0,0,0,0
15.** **LONG-TERM DEBT,0,0,0,0,0
16.** **DERIVATIVES AND HEDGING ACTIVITIES,0,0,0,0,0
17.** **REDEEMABLE NON-CONTROLLING INTERESTS AND SHAREHOLDERS’ EQUITY,0,0,0,0,0
18.** **CHANGES IN ACCUMULATED OTHER COMPREHENSIVE (LOSS),0,0,0,0,0
20.** **FAIR VALUE MEASUREMENTS,0,0,0,0,0
22.** **RELATED PARTY TRANSACTIONS,0,0,0,0,0
23.** **SUBSEQUENT EVENTS,0,0,0,0,0
INDEPENDENT REGISTERED PUBLIC ACCOUNTING FIRM KPMG,0,0,0,0,0
LEGAL ADVISORS TO THE** **LEGAL ADVISORS TO THE** **REGISTRAR** **LISTING AGENT SECURITY AGENT** **TRUSTEE,0,0,0,0,0
IMPORTANT NOTICE (FOR ELECTRONIC DELIVERY),0,0,0,0,0
PRELIMINARY OFFERING MEMORANDUM** **NOT FOR GENERAL CIRCULATION STRICTLY CONFIDENTIAL** **IN THE UNITED STATES,0,0,0,0,0
SUMMARY HISTORICAL CONSOLIDATED FINANCIAL INFORMATION AND OTHER FINANCIAL AND OPERATING DATA OF REFRESCO,0,0,0,0,0
SUMMARY HISTORICAL COMBINED CARVE-OUT FINANCIAL INFORMATION AND OTHER FINANCIAL AND OPERATING DATA OF COTT TB,0,0,0,0,0
SELECTED CONSOLIDATED FINANCIAL INFORMATION OF REFRESCO,0,0,0,0,0
SELECTED COMBINED CARVE-OUT FINANCIAL INFORMATION OF COTT TB,0,0,0,0,0
MANAGEMENT’S DISCUSSION AND ANALYSIS OF FINANCIAL CONDITION AND RESULTS OF OPERATIONS OF REFRESCO,0,0,0,0,0
MANAGEMENT’S DISCUSSION AND ANALYSIS OF FINANCIAL CONDITION AND RESULTS OF OPERATIONS OF COTT TB,0,0,0,0,0
LIQUIDITY AND CAPITAL RESOURCES,0,0,0,0,0
LIMITATIONS ON VALIDITY AND ENFORCEABILITY OF THE SECURITY INTERESTS AND ANY NOTE GUARANTEES,0,0,0,0,0
COTT TRADITIONAL BUSINESS COMBINED CARVE-OUT STATEMENT OF EQUITY,0,0,0,0,0
COTT TRADITIONAL BUSINESS COMBINED CARVE-OUT STATEMENTS OF OPERATIONS,0,0,0,0,0
COTT TRADITIONAL BUSINESS COMBINED CARVE-OUT STATEMENTS OF COMPREHENSIVE INCOME (LOSS),0,0,0,0,0
COTT TRADITIONAL BUSINESS COMBINED CARVE-OUT BALANCE SHEETS,0,0,0,0,0
COTT TRADITIONAL BUSINESS COMBINED CARVE-OUT STATEMENTS OF CASH FLOWS,0,0,0,0,0
COTT TRADITIONAL BUSINESS COMBINED CARVE-OUT STATEMENTS OF EQUITY,0,0,0,0,0
"STABILIZATION IN CONNECTION WITH THIS OFFERING, DEUTSCHE BANK AG, LONDON BRANCH (THE “DOLLAR SENIOR SECURED NOTES STABILIZING MANAGER”), DEUTSCHE BANK AG, LONDON BRANCH (THE “EURO SENIOR SECURED NOTES STABILIZING MANAGER”) AND",0,0,0,0,0
NOTICE TO INVESTORS IN BELGIUM,0,0,0,0,0
NOTICE TO INVESTORS IN THE REPUBLIC OF ITALY,0,0,0,0,0
NOTICE TO INVESTORS IN THE REPUBLIC OF IRELAND,0,0,0,0,0
NOTICE TO INVESTORS IN SWEDEN,0,0,0,0,0
NOTICE TO INVESTORS IN NORWAY,0,0,0,0,0
NOTICE TO INVESTORS IN DENMARK,0,0,0,0,0
BANIJAY’S SUMMARY HISTORICAL FINANCIAL AND OTHER INFORMATION,0,0,0,0,0
ENDEMOL SHINE’S SUMMARY HISTORICAL FINANCIAL AND OTHER INFORMATION,0,0,0,0,0
BANIJAY’S MANAGEMENT’S DISCUSSION AND ANALYSIS OF FINANCIAL CONDITION AND RESULTS OF OPERATIONS,0,0,0,0,0
ENDEMOL SHINE’S MANAGEMENT’S DISCUSSION AND ANALYSIS OF FINANCIAL CONDITION AND RESULTS OF OPERATIONS,0,0,0,0,0
BANIJAY’S BUSINESS,0,0,0,0,0
1. INTERIM CONDENSED CONSOLIDATED STATEMENT OF PROFIT OR LOSS,0,0,0,0,0
2. INTERIM CONDENSED CONSOLIDATED STATEMENT OF FINANCIAL POSITION ASSETS,0,0,0,0,0
3. INTERIM CONDENSED CONSOLIDATED STATEMENT OF CASH FLOWS,0,0,0,0,0
5. NOTES TO INTERIM CONDENSED CONSOLIDATED FINANCIAL STATEMENTS,0,0,0,0,0
1.** **CONSOLIDATED STATEMENT OF PROFIT OR LOSS,0,0,0,0,0
2.** **CONSOLIDATED STATEMENT OF FINANCIAL POSITION ASSETS,0,0,0,0,0
3.** **CONSOLIDATED STATEMENT OF CASH FLOWS,0,0,0,0,0
5.** **NOTES TO CONSOLIDATED FINANCIAL STATEMENTS,0,0,0,0,0
1. CONSOLIDATED STATEMENT OF PROFIT OR LOSS,0,0,0,0,0
2. CONSOLIDATED STATEMENT OF FINANCIAL POSITION ASSETS,0,0,0,0,0
3. CONSOLIDATED STATEMENT OF CASH FLOWS,0,0,0,0,0
5. NOTES TO CONSOLIDATED FINANCIAL STATEMENTS,0,0,0,0,0
"140,662 EQUITY AND LIABILITIES",0,0,0,0,0
CONSOLIDATED FINANCIAL STATEMENTS,0,0,0,0,0
COMPANY FINANCIAL STATEMENTS,0,0,0,0,0
NOTES TO THE COMPANY FINANCIAL STATEMENTS,0,0,0,0,0
MATERIAL DIFFERENCES BETWEEN THE CONSOLIDATED FINANCIAL STATEMENTS OF HOLDINGS AND THE FINANCIAL INFORMATION OF THE ISSUERS,0,0,0,0,0
NON-GAAP FINANCIAL MEASURES OF HOLDINGS,0,0,0,0,0
CERTAIN INFORMATION REGARDING CAESARS AND ERI,0,0,0,0,0
CAPITALIZATION OF HOLDINGS,0,0,0,0,0
UNAUDITED PRO FORMA CONSOLIDATED AND COMBINED FINANCIAL STATEMENTS OF HOLDINGS,0,0,0,0,0
SUMMARY HISTORICAL AND PRO FORMA CONSOLIDATED FINANCIAL INFORMATION,0,0,0,0,0
NOTE 1 - NATURE OF BUSINESS AND SIGNIFICANT ACCOUNTING POLICIES,0,0,0,0,0
NOTE 2 - ACQUISITIONS,0,0,0,0,0
NOTE 3 - INVENTORIES,0,0,0,0,0
NOTE 4 - NOTES RECEIVABLE,0,0,0,0,0
"NOTE 5 - PROPERTY, PLANT AND EQUIPMENT",0,0,0,0,0
NOTE 6 - ACCRUED EXPENSES,0,0,0,0,0
NOTE 7 - CREDIT AGREEMENTS,0,0,0,0,0
NOTE 8 - LEASES,0,0,0,0,0
NOTE 9 - PENSION PLANS,0,0,0,0,0
NOTE 10 - INCOME TAXES,0,0,0,0,0
NOTE 11 - STOCKHOLDERS’ EQUITY,0,0,0,0,0
NOTE 12 - CONTINGENCIES,0,0,0,0,0
NOTE 13 - FAIR VALUE MEASUREMENTS,0,0,0,0,0
NOTE 14 - PROFIT-SHARING RETIREMENT PLAN,0,0,0,0,0
NOTE 15 - SUBSEQUENT EVENTS,0,0,0,0,0
NOTE 11 - CONTINGENCIES,0,0,0,0,0
NOTE 12 - FAIR VALUE MEASUREMENTS,0,0,0,0,0
NOTE 13 - EMPLOYEE RETIREMENT SAVINGS PLAN,0,0,0,0,0
NOTE 14 - SUBSEQUENT EVENTS,0,0,0,0,0
NOTICE TO CAYMAN INVESTORS NO INVITATION WHETHER DIRECTLY OR INDIRECTLY MAY BE MADE TO THE PUBLIC IN THE CAYMAN ISLANDS TO SUBSCRIBE FOR THE NOTES. NOTICE TO CANADIAN INVESTORS,0,0,0,0,0
PRESENTATION OF FINANCIAL DATA,0,0,0,0,0
NON-IFRS FINANCIAL AND OTHER INFORMATION,0,0,0,0,0
CURRENCIES,0,0,0,0,0
CERTAIN DEFINITIONS RELATING TO THE GROUP AND THE TRANSACTIONS,0,0,0,0,0
CERTAIN INSOLVENCY LAW CONSIDERATIONS AND LIMITATIONS ON VALIDITY AND ENFORCEABILITY OF GUARANTEES AND SECURITY,0,0,0,0,0
"TERMINATION DATE”), OFFER, SELL OR OTHERWISE TRANSFER THIS NOTE EXCEPT",0,0,0,0,0
INSTITUTIONAL BUYER” AS DEFINED IN RULE 144A UNDER THE U.S. SECURITIES ACT,0,0,0,0,0
INCORPORATION BY REFERENCE OF CERTAIN DOCUMENTS,0,0,0,0,0
DESCRIPTION OF THE EURO NOTES AND THE GUARANTEES,0,0,0,0,0
DESCRIPTION OF THE USD NOTES AND THE GUARANTEES,0,0,0,0,0
DUTCH TAX CONSIDERATIONS,0,0,0,0,0
ISRAELI TAX CONSIDERATIONS,0,0,0,0,0
CERTAIN INSOLVENCY LAW CONSIDERATIONS; LIMITATIONS ON VALIDITY AND ENFORCEABILITY OF THE NOTES AND THE INDENTURES,0,0,0,0,0
FINANCE SUBSIDIARIES,0,0,0,0,0
DESCRIPTION OF ORDINARY SHARES,0,0,0,0,0
DESCRIPTION OF AMERICAN DEPOSITARY SHARES,0,0,0,0,0
DESCRIPTION OF DEBT SECURITIES AND GUARANTEES,0,0,0,0,0
DESCRIPTION OF PURCHASE CONTRACTS,0,0,0,0,0
DESCRIPTION OF UNITS,0,0,0,0,0
R$** **€,0,0,0,0,0
NOTES TO THE CONSOLIDATED STATEMENT OF COMPREHENSIVE INCOME INTRODUCTION,0,0,0,0,0
"TOTAL NON-CURRENT ASSETS . . . . . . . . . . . . . . . . . . . . . . . . . . . . . . . . . . . . . . . . . . .** **218,212,132",0,0,0,0,0
"TOTAL SHAREHOLDERS’ EQUITY ATTRIBUTABLE TO THE GROUP . . . . . . . .** **163,328,841",0,0,0,0,0
"TOTAL SHAREHOLDERS’ EQUITY . . . . . . . . . . . . . . . . . . . . . . . . . . . . . . . . . . . . . . . .** **164,419,092 NON-CURRENT LIABILITIES",0,0,0,0,0
"TOTAL NON-CURRENT LIABILITIES . . . . . . . . . . . . . . . . . . . . . . . . . . . . . . . . . . . . . .** **90,468,100 CURRENT LIABILITIES",0,0,0,0,0
"TOTAL VALUE OF PRODUCTION . . . . . . . . . . . . . . . . . . . . . . . . . . . . . . . . . . . . . . . . . .** **157,782,276",0,0,0,0,0
"TOTAL COMPREHENSIVE INCOME FOR THE YEAR . . . . . . . . . . . . . . . . . . . . . . . .** **2,207,315",0,0,0,0,0
"THE FOLLOWING DISCUSSION IS FOR INFORMATIONAL PURPOSES ONLY AND IS NOT A SUBSTITUTE FOR CAREFUL TAX PLANNING AND ADVICE. HOLDERS SHOULD CONSULT THEIR TAX ADVISORS WITH RESPECT TO THE APPLICATION OF THE U.S. FEDERAL INCOME TAX LAWS TO THE ACQUISITION, OWNERSHIP AND DISPOSITION OF THE NOTES IN LIGHT OF THEIR PARTICULAR SITUATIONS, AS WELL AS ANY TAX CONSEQUENCES ARISING UNDER OTHER U.S. FEDERAL TAX LAWS OR THE LAWS OF ANY STATE, LOCAL OR NON-UNITED STATES TAXING JURISDICTION OR UNDER ANY APPLICABLE TAX TREATY.",0,0,0,0,0
NI** **SER,0,0,0,0,0
TRUSTEE** **LEGAL ADVISORS TO THE TRUSTEE,0,0,0,0,0
"THE NOTES AND RELATED GUARANTEES DESCRIBED IN THIS OFFERING CIRCULAR HAVE NOT BEEN REGISTERED WITH, RECOMMENDED BY OR APPROVED BY THE U.S. SECURITIES AND EXCHANGE COMMISSION (THE “SEC”) OR ANY OTHER FEDERAL, STATE OR PROVINCIAL SECURITIES COMMISSION OR REGULATORY AUTHORITY, NOR HAS THE SEC OR ANY SUCH FEDERAL, STATE OR PROVINCIAL SECURITIES COMMISSION OR REGULATORY AUTHORITY PASSED UPON** **THE** **ACCURACY OR** **ADEQUACY OF** **THIS OFFERING CIRCULAR. ANY REPRESENTATION TO THE CONTRARY IS A CRIMINAL OFFENSE.",0,0,0,0,0
"MARKET SHARE, RANKING AND SIMILAR INFORMATION",0,0,0,0,0
UNAUDITED CONDENSED CONSOLIDATED PRO FORMA FINANCIAL INFORMATION,0,0,0,0,0
SELECTED CONSOLIDATED HISTORICAL FINANCIAL DATA,0,0,0,0,0
CERTAIN UNITED STATES FEDERAL TAX CONSIDERATIONS,0,0,0,0,0
USE OF CERTAIN TERMS,0,0,0,0,0
THE REFINANCING,0,0,0,0,0
EXISTING SENIOR SECURED PLN FACILITIES,0,0,0,0,0
EXISTING SENIOR SECURED GBP FACILITY,0,0,0,0,0
EXISTING SENIOR SECURED HSBC FACILITY,0,0,0,0,0
NEW SENIOR SECURED ERSTE BANK FACILITY,0,0,0,0,0
MARKET AND OTHER DATA,0,0,0,0,0
UNAUDITED PRO FORMA CONDENSED COMBINED BALANCE SHEET,0,0,0,0,0
MANAGEMENT’S DISCUSSION AND ANALYSIS OF FINANCIAL CONDITION AND RESULTS OF OPERATIONS OF PARENT,0,0,0,0,0
MANAGEMENT’S DISCUSSION AND ANALYSIS OF FINANCIAL CONDITION AND RESULTS OF OPERATIONS OF DIVERSEY,0,0,0,0,0
NOTE 4 - ACQUISITIONS,0,0,0,0,0
"NOTE 6 - PROPERTY AND EQUIPMENT, NET",0,0,0,0,0
NOTE 8 - DEBT AND CREDIT FACILITIES,0,0,0,0,0
NOTE 9 - DERIVATIVES AND HEDGING ACTIVITIES,0,0,0,0,0
NOTE 11 - DEFINED BENEFIT PENSION PLANS AND OTHER POST-EMPLOYMENT BENEFIT PLANS,0,0,0,0,0
NOTE 12 - INCOME TAXES,0,0,0,0,0
NOTE 13 - COMMITMENTS AND CONTINGENCIES,0,0,0,0,0
NOTE 16 - RESTRUCTURING AND EXIT ACTIVITIES,0,0,0,0,0
NOTE 17 - ACCUMULATED OTHER COMPREHENSIVE LOSS,0,0,0,0,0
NOTE 18 - SEGMENTS,0,0,0,0,0
NOTE 19 - EARNINGS (LOSS) PER SHARE,0,0,0,0,0
NOTE 1 - GENERAL AND DESCRIPTION OF BUSINESS,0,0,0,0,0
NOTE 2 - BASIS OF PRESENTATION,0,0,0,0,0
NOTE 4 - REVENUE RECOGNITION,0,0,0,0,0
NOTE 5 - ACQUISITIONS,0,0,0,0,0
"NOTE 7 PROPERTY AND EQUIPMENT, NET",0,0,0,0,0
NOTE 10 - DEBT AND CREDIT FACILITIES,0,0,0,0,0
NOTE 11 - DERIVATIVES AND HEDGING ACTIVITIES,0,0,0,0,0
NOTE 14 - INCOME TAXES,0,0,0,0,0
NOTE 15 - COMMITMENTS AND CONTINGENCIES,0,0,0,0,0
NOTE 17 - SHARE-BASED COMPENSATION,0,0,0,0,0
NOTE 18 - RESTRUCTURING AND EXIT ACTIVITIES,0,0,0,0,0
NOTE 19 - ACCUMULATED OTHER COMPREHENSIVE LOSS,0,0,0,0,0
NOTE 20 - SEGMENTS,0,0,0,0,0
NOTE 21 - EARNINGS (LOSS) PER SHARE,0,0,0,0,0
NOTE 22 - SUBSEQUENT EVENTS,0,0,0,0,0
DESCRIPTION OF NEW CREDIT FACILITIES AND OTHER INDEBTEDNESS,0,0,0,0,0
"MANAGERS”) (OR PERSONS ACTING ON BEHALF OF THE STABILIZING MANAGERS), MAY OVER-",0,0,0,0,0
CORPORATE AND FINANCING STRUCTURE CHART,0,0,0,0,0
SUMMARY FINANCIAL AND OPERATING DATA OF THE VIRGIN MEDIA GROUP,0,0,0,0,0
SUMMARY FINANCIAL AND OPERATING DATA OF THE O2 GROUP,0,0,0,0,0
UNAUDITED CONDENSED PRO FORMA COMBINED FINANCIAL STATEMENTS OF JV HOLDCO,0,0,0,0,0
CERTAIN PRO FORMA AS ADJUSTED COVENANT AND OTHER INFORMATION,0,0,0,0,0
MANAGEMENT’S DISCUSSION AND ANALYSIS OF FINANCIAL CONDITION AND RESULTS OF OPERATIONS OF THE O2 GROUP,0,0,0,0,0
SUSTAINABILITY OF THE O2 GROUP,0,0,0,0,0
SUSTAINABILITY OF THE VIRGIN MEDIA GROUP,0,0,0,0,0
MANAGEMENT AND GOVERNANCE OF THE JOINT VENTURE,0,0,0,0,0
REGULATION OF THE O2 GROUP,0,0,0,0,0
DESCRIPTION OF THE INTERCREDITOR DEEDS,0,0,0,0,0
DESCRIPTION OF THE VM CREDIT FACILITY AND THE RELATED AGREEMENTS,0,0,0,0,0
DESCRIPTION OF OTHER DEBT,0,0,0,0,0
CERTAIN MATERIAL UNITED KINGDOM TAX CONSIDERATIONS,0,0,0,0,0
LIABILITIES AND OWNER’S EQUITY (DEFICIT),0,0,0,0,0
ANNEX A: VM CREDIT FACILITY,0,0,0,0,0
21.18 ERISA,0,0,0,0,0
23.22 ERISA,0,0,0,0,0
30.** **BREAK COSTS,0,0,0,0,0
38.** **REMEDIES AND WAIVERS,0,0,0,0,0
40.** **ENGLISH LANGUAGE,0,0,0,0,0
41.** **PARTIAL INVALIDITY,0,0,0,0,0
43.** **THIRD PARTY RIGHTS,0,0,0,0,0
44.** **COUNTERPARTS,0,0,0,0,0
45.** **GOVERNING LAW,0,0,0,0,0
47.** **COMPLETE AGREEMENT,0,0,0,0,0
SCHEDULE 5 FORM OF TRANSFER DEED,0,0,0,0,0
ACCESSION TO THE HYD INTERCREDITOR AGREEMENT,0,0,0,0,0
ACCESSION TO THE GROUP INTERCREDITOR AGREEMENT,0,0,0,0,0
ACCESSION TO THE SECURITY TRUST AGREEMENT,0,0,0,0,0
ASSIGNOR[S][21],0,0,0,0,0
[NAME OF ASSIGNOR],0,0,0,0,0
ASSIGNEE[S][22] [NAME OF ASSIGNEE],0,0,0,0,0
[NAME OF ASSIGNEE],0,0,0,0,0
[NAME OF RELEVANT PARTY],0,0,0,0,0
SCHEDULE 8 ACCESSION DOCUMENTS,0,0,0,0,0
[INSERT APPROPRIATE SIGNATURE BLOCK FOR EACH ADDITIONAL FACILITY LENDER(S)] THE COMPANY,0,0,0,0,0
SCOTTISH SECURITY DOCUMENTS,0,0,0,0,0
NEW YORK SECURITY DOCUMENTS,0,0,0,0,0
CHARGOR** **DATE** **BENEFICIARY** **SUMMARY,0,0,0,0,0
"TOTAL . . . . . . . . . . . . . . . . . . . . . . . . . . . . . . . . . . . . . . . . . . . . . . . . . . . . . . . . . . . . . . . . . . . . .** **965,175,295.45",0,0,0,0,0
SCHEDULE 13 EXISTING HEDGE COUNTERPARTIES,0,0,0,0,0
SCHEDULE 14 FORM OF L/C BANK ACCESSION CERTIFICATE,0,0,0,0,0
SCHEDULE 16 FORM OF INCREASE CONFIRMATION,0,0,0,0,0
SCHEDULE 17 FORM OF RESIGNATION LETTER,0,0,0,0,0
SCHEDULE 19 AGREED SECURITY PRINCIPLES,0,0,0,0,0
SENIOR FACILITIES AGREEMENT EXECUTION PAGES,0,0,0,0,0
DEED OF COVENANT,0,0,0,0,0
VIRGIN MEDIA INVESTMENT HOLDINGS LIMITED,0,0,0,0,0
VMED O2 UK FINANCING I PLC,0,0,0,0,0
3.** **COMPANY’S AND NEW VM CREDIT FACILITY BORROWER’S LIABILITY,0,0,0,0,0
10. THIRD PARTY RIGHTS,0,0,0,0,0
11. PARTIAL INVALIDITY,0,0,0,0,0
12. COUNTERPARTS,0,0,0,0,0
ANNEX C: FORM OF NEW GROUP INTERCREDITOR AGREEMENT,0,0,0,0,0
INTERCREDITOR AGREEMENT[1],0,0,0,0,0
6.** **ISSUE OF SENIOR SECURED NOTES,0,0,0,0,0
7.** **ENTRY INTO PARI PASSU DEBT DOCUMENTS,0,0,0,0,0
31.** **COUNTERPARTS,0,0,0,0,0
32.** **BAIL-IN,0,0,0,0,0
33.** **QFC CREDIT SUPPORT,0,0,0,0,0
34.** **GOVERNING LAW,0,0,0,0,0
SCHEDULE 4 SECOND LIEN MAJOR TERMS,0,0,0,0,0
SCHEDULE 5 HIGH YIELD MAJOR TERMS,0,0,0,0,0
SCHEDULE 6 UNSECURED MAJOR TERMS,0,0,0,0,0
INTERCREDITOR AGREEMENT EXECUTION PAGES,0,0,0,0,0
ANNEX D: FORM OF FINCO FACILITY $ ACCESSION AGREEMENT,0,0,0,0,0
VIRGIN MEDIA – US DOLLAR ADDITIONAL FACILITY W ACCESSION DEED,0,0,0,0,0
SCHEDULE 3,0,0,0,0,0
"SCHEDULE 4 THIRD AMENDMENTS, WAIVERS, CONSENTS AND OTHER MODIFICATIONS",0,0,0,0,0
"SCHEDULE 5 FOURTH AMENDMENTS, WAIVERS, CONSENTS AND OTHER MODIFICATIONS",0,0,0,0,0
"SCHEDULE 6 FIFTH AMENDMENTS, WAIVERS, CONSENTS AND OTHER MODIFICATIONS",0,0,0,0,0
"SCHEDULE 7 SIXTH AMENDMENTS, WAIVERS, CONSENTS AND OTHER MODIFICATIONS",0,0,0,0,0
VIRGIN MEDIA FINANCE PLC,0,0,0,0,0
THE OBLIGORS THE BANK OF NOVA SCOTIA,0,0,0,0,0
BNY MELLON CORPORATE TRUSTEE SERVICES LIMITED,0,0,0,0,0
THE EFFECTIVE DATE HEDGE COUNTERPARTIES BANK OF NEW YORK MELLON,0,0,0,0,0
"2.** **AMENDMENT** **OF** **THE** **GROUP** **ICA,** **HIGH** **YIELD** **ICA** **AND** **SECURITY** **TRUST AGREEMENT",0,0,0,0,0
3.** **BARCLAYS INTERCREDITOR,0,0,0,0,0
4.** **REPRESENTATIONS,0,0,0,0,0
5.** **GUARANTEE AND SECURITY,0,0,0,0,0
6.** **ACKNOWLEDGEMENTS,0,0,0,0,0
7.** **CONFIRMATIONS,0,0,0,0,0
8.** **MISCELLANEOUS,0,0,0,0,0
9.** **GOVERNING LAW,0,0,0,0,0
SCHEDULE 2 AMENDED GROUP ICA,0,0,0,0,0
ANNEX E: FORM OF FINCO FACILITY £ ACCESSION AGREEMENT,0,0,0,0,0
VIRGIN MEDIA — STERLING ADDITIONAL FACILITY V ACCESSION DEED,0,0,0,0,0
SCHEDULE 8 ICA AMENDMENT AND RESTATEMENT DEED,0,0,0,0,0
[Š] 2020 BETWEEN VIRGIN MEDIA INVESTMENT HOLDINGS LIMITED,0,0,0,0,0
SCHEDULE 1 CONDITIONS PRECEDENT,0,0,0,0,0
INDEPENDENT AUDITORS TO THE ISSUER KPMG LLP,0,0,0,0,0
INDEPENDENT AUDITORS TO VIRGIN MEDIA INC. KPMG LLP,0,0,0,0,0
INDEPENDENT AUDITORS TO O2 HOLDINGS LIMITED,0,0,0,0,0
"GENERAL DESCRIPTION OF VODAFONEZIGGO’S BUSINESS, THE ISSUER AND THE OFFERING",0,0,0,0,0
SUMMARY FINANCIAL AND OPERATING DATA OF VODAFONEZIGGO,0,0,0,0,0
PARTIES:,0,0,0,0,0
CAPITALIZATION OF VODAFONEZIGGO,0,0,0,0,0
SELECTED CONSOLIDATED FINANCIAL AND OPERATING DATA OF VODAFONEZIGGO,0,0,0,0,0
ANNEX A: NEW VFZ FACILITIES AGREEMENT,0,0,0,0,0
17.** **CHANGES TO THE LENDER,0,0,0,0,0
20.** **SET-OFF,0,0,0,0,0
22.** **ADMINISTRATOR,0,0,0,0,0
24.** **PARTIAL INVALIDITY,0,0,0,0,0
26.** **REMEDIES AND WAIVERS,0,0,0,0,0
27.** **AMENDMENTS AND WAIVERS,0,0,0,0,0
28.** **TERMINATION OF CERTAIN PROVISIONS,0,0,0,0,0
29.** **COUNTERPARTS,0,0,0,0,0
30.** **GOVERNING LAW,0,0,0,0,0
32.** **COMPLETE AGREEMENT,0,0,0,0,0
SCHEDULE 3 FORM OF OBLIGOR ACCESSION AGREEMENT,0,0,0,0,0
SCHEDULE 4 FORM OF RESIGNATION LETTER,0,0,0,0,0
SCHEDULE 5 COVENANTS,0,0,0,0,0
SCHEDULE 6 EVENTS OF DEFAULT,0,0,0,0,0
THE BORROWER VZ FINANCING I B.V.,0,0,0,0,0
THE GUARANTORS VZ FINANCING I B.V.,0,0,0,0,0
VODAFONEZIGGO GROUP B.V.,0,0,0,0,0
VZ FINANCING II B.V.,0,0,0,0,0
"THE ADMINISTRATOR [THE BANK OF NEW YORK MELLON, LONDON BRANCH]",0,0,0,0,0
NOTES TRUSTEE AND SECURITY TRUSTEE** **LISTING AGENT,0,0,0,0,0
DESCRIPTION OF EXISTING INDEBTEDNESS,0,0,0,0,0
MATERIAL U.S. FEDERAL TAX CONSIDERATIONS FOR HOLDERS,0,0,0,0,0
REFINANCING TRANSACTIONS,0,0,0,0,0
MATERIAL NETHERLANDS TAX CONSEQUENCES,0,0,0,0,0
DESCRIPTION OF THE TEMPORARY NOTES,0,0,0,0,0
INDEPENDENT AUDITORS OF ISSUER KPMG AB,0,0,0,0,0
PRELIMINARY OFFERING MEMORANDUM** **STRICTLY CONFIDENTIAL,0,0,0,0,0
"THE NOTES HAVE NOT BEEN REGISTERED WITH, RECOMMENDED BY OR APPROVED BY THE U.S. SECURITIES AND EXCHANGE COMMISSION (THE “SEC”), ANY SECURITIES COMMISSION OR SIMILAR REGULATORY AUTHORITY OF ANY PROVINCE OR TERRITORY OF CANADA, OR ANY OTHER REGULATORY SECURITIES COMMISSION OF ANY COUNTRY OR AUTHORITY. NEITHER THE SEC, NOR ANY SECURITIES COMMISSION OR SIMILAR REGULATORY AUTHORITY OF ANY PROVINCE OR TERRITORY OF CANADA OR ANY OTHER REGULATORY COMMISSION OR AUTHORITY HAS APPROVED OR DISAPPROVED OF THESE SECURITIES OR DETERMINED IF THIS OFFERING MEMORANDUM IS TRUTHFUL OR COMPLETE. ANY REPRESENTATION TO THE CONTRARY IS A CRIMINAL OFFENSE.",0,0,0,0,0
GENERAL MATTERS,0,0,0,0,0
NON-IFRS FINANCIAL MEASURES,0,0,0,0,0
GLOSSARY AND CERTAIN DEFINED TERMS,0,0,0,0,0
SUMMARY HISTORICAL AND AS ADJUSTED FINANCIAL INFORMATION,0,0,0,0,0
TRANSFER AGENT AND REGISTRAR,0,0,0,0,0
PRELIMINARY OFFERING MEMORANDUM** **CONFIDENTIAL NOT FOR GENERAL DISTRIBUTION IN THE UNITED STATES ELIOR GROUP S.A.,0,0,0,0,0
CERTAIN FRENCH TAX CONSIDERATIONS,0,0,0,0,0
IN THE UNITED STATES ELIOR GROUP S.A.,0,0,0,0,0
B&B,0,0,0,0,0
1** **CORPORATE INFORMATION,0,0,0,0,0
1.1 THE GROUP—MISSION AND BRANDS,0,0,0,0,0
FLOS,0,0,0,0,0
MAXALTO,0,0,0,0,0
ARCLINEA,0,0,0,0,0
AZUCENA,0,0,0,0,0
LUMENS,0,0,0,0,0
1.2 COMPANY THAT EXERCISES MANAGEMENT AND COORDINATION ACTIVITIES,0,0,0,0,0
1.3 STATEMENT OF FINANCIAL POSITION OF THE ULTIMATE PARENT COMPANY THAT EXERCISES MANAGEMENT AND COORDINATION ACTIVITIES,0,0,0,0,0
2** **ACCOUNTING POLICIES,0,0,0,0,0
3** **BASIS OF CONSOLIDATION,0,0,0,0,0
4** **SUMMARY OF THE MAIN ACCOUNTING POLICIES,0,0,0,0,0
4.1** **BUSINESS COMBINATIONS AND GOODWILL,0,0,0,0,0
4.2** **CURRENT/NON-CURRENT CLASSIFICATION,0,0,0,0,0
4.3** **TRANSLATION OF FINANCIAL STATEMENTS EXPRESSED IN A DIFFERENT CURRENCY FROM THE FUNCTIONAL CURRENCY,0,0,0,0,0
4.4** **FAIR VALUE MEASUREMENT,0,0,0,0,0
4.5** **REVENUE RECOGNITION,0,0,0,0,0
4.5.1** **SALE OF GOODS,0,0,0,0,0
4.5.2** **DIVIDENDS,0,0,0,0,0
4.5.3** **RENTAL REVENUES,0,0,0,0,0
4.6.2** **DEFERRED TAX ASSETS AND LIABILITIES,0,0,0,0,0
4.6.3** **INDIRECT TAXES,0,0,0,0,0
4.7** **NON-CURRENT ASSETS HELD FOR DISPOSAL,0,0,0,0,0
"4.8** **PROPERTY, PLANT AND EQUIPMENT",0,0,0,0,0
4.9** **LEASING,0,0,0,0,0
4.10** **OTHER INTANGIBLE ASSETS,0,0,0,0,0
4.10.1 RESEARCH AND DEVELOPMENT COSTS,0,0,0,0,0
4.10.2 LICENCES AND SIMILAR RIGHTS,0,0,0,0,0
DEPRECIATION RATE,0,0,0,0,0
4.10.3 TRADEMARK,0,0,0,0,0
4.11** **FINANCIAL ASSETS,0,0,0,0,0
4.12** **FINANCIAL LIABILITIES,0,0,0,0,0
4.13** **INVENTORIES,0,0,0,0,0
4.14** **IMPAIRMENT OF NON-FINANCIAL ASSETS,0,0,0,0,0
4.14.1 GOODWILL,0,0,0,0,0
4.14.2 TRADEMARKS,0,0,0,0,0
4.15** **CASH AND CASH EQUIVALENTS AND SHORT-TERM DEPOSITS,0,0,0,0,0
4.16** **TREASURY SHARES,0,0,0,0,0
4.17** **PROVISIONS FOR RISKS AND CHARGES,0,0,0,0,0
4.18** **PENSIONS AND OTHER POST-EMPLOYMENT BENEFITS,0,0,0,0,0
4.19** **SHARE-BASED PAYMENTS,0,0,0,0,0
ONEROUS CONTRACTS—COSTS OF FULFILLING A CONTRACT—AMENDMENTS TO IAS 37,0,0,0,0,0
REFERENCE TO THE CONCEPTUAL FRAMEWORK—AMENDMENTS TO IFRS 3,0,0,0,0,0
"PROPERTY, PLANT AND EQUIPMENT: PROCEEDS BEFORE INTENDED USE—AMENDMENTS TO IAS 16",0,0,0,0,0
5.2** **STANDARDS ISSUED BUT NOT YET EFFECTIVE,0,0,0,0,0
6** **DISCRETIONARY VALUTATIONS AND SIGNIFICANT ACCOUNTING ESTIMATES,0,0,0,0,0
6.1** **SIGNIFICANT** **JUDGMENT** **IN** **DETERMINING** **THE** **DURATION** **OF** **THE** **LEASING** **OF CONTRACTS THAT CONTAIN AN EXTENSION OPTION,0,0,0,0,0
6.2** **JUDGMENETS,0,0,0,0,0
6.3** **ESTIMATES AND ASSUMPTIONS,0,0,0,0,0
6.3.1 IMPAIRMENT OF NON-FINANCIAL ASSETS,0,0,0,0,0
6.3.2 PROVISION FOR EXPECTED CREDIT LOSSES OF TRADE RECEIVABLES AND CONTRACT ASSETS,0,0,0,0,0
6.3.3 FINANCIAL RISK MANAGEMENT OBJECTIVES AND CRITERIA,0,0,0,0,0
6.3.4 INTEREST RATE RISK,0,0,0,0,0
6.3.5 EXCHANGE RATE RISK,0,0,0,0,0
6.3.6** **CREDIT RISK,0,0,0,0,0
6.3.7** **FINANCIAL INSTRUMENTS AND BANK DEPOSITS,0,0,0,0,0
6.3.8** **LIQUIDITY RISK,0,0,0,0,0
6.5** **CAPITAL MANAGEMENT,0,0,0,0,0
6.6** **FAIR VALUE MEASUREMENT,0,0,0,0,0
6.7** **SEGMENT INFORMATION,0,0,0,0,0
7** **CASH AND SHORT-TERM DEPOSITS,0,0,0,0,0
8** **TRADE RECEIVABLES,0,0,0,0,0
9** **INVENTORIES,0,0,0,0,0
11** **OTHER CURRENT ASSETS,0,0,0,0,0
12** **GOODWILL,0,0,0,0,0
13** **BRANDS AND OTHER INTANGIBLE ASSETS,0,0,0,0,0
"TOTAL BRANDS AND OTHER INTANGIBLE ASSETS CONCESSIONS, LICENSES AND OTHER INTANGIBLE ASSETS DEVELOPMENT TRADEMARK** **COSTS PATENTS AND INTELLECTUAL PROPERTY RIGHTS",0,0,0,0,0
"14** **PROPERTY, PLANT AND EQUIPMENT",0,0,0,0,0
"WORK IN PROGRESS AND ADVANCES TOTAL PROPERTY, PLANT AND EQUIP. LAND AND** **PLANT AND** **LEASEHOLD BUILDINGS** **MACHINERY** **IMPROVEMENTS INDUSTRIAL AND COMMERCIAL** **OTHER EQUIPMENT** **ASSETS",0,0,0,0,0
15** **RIGHT OF USE ASSETS AND LEASE LIABILITIES,0,0,0,0,0
TOTAL RIGHT OF USE ASSET LAND AND** **PLANT AND BUILDINGS** **MACHINERY INDUSTRIAL & COMMERCIAL** **OTHER EQUIPEMENT** **ASSETS,0,0,0,0,0
16** **INVESTMENTS IN PARENT COMPANY,0,0,0,0,0
17** **DEFERRED TAX ASSETS,0,0,0,0,0
19** **ASSETS HELD FOR DISPOSAL,0,0,0,0,0
20** **TOTAL SHAREHOLDERS’ EQUITY,0,0,0,0,0
21** **CURRENT AND NON-CURRENT FINANCIAL LIABILITIES,0,0,0,0,0
23** **CURRENT TAX LIABILITIES,0,0,0,0,0
26** **PROVISIONS FOR RISKS AND CHARGES,0,0,0,0,0
27** **DEFERRED TAX LIABILITIES,0,0,0,0,0
28** **OTHER NON-CURRENT LIABILITIES,0,0,0,0,0
29** **RELATED PARTY DISCOUSURE,0,0,0,0,0
30** **REVENUES,0,0,0,0,0
31** **PURCHASES OF RAW MATERIALS AND CHANGES IN INVENTORIES,0,0,0,0,0
32** **PERSONNEL COSTS,0,0,0,0,0
34** **PROVISIONS,0,0,0,0,0
35** **OTHER COSTS AND CHARGES,0,0,0,0,0
39** **EARNINGS PER SHARE (EPS),0,0,0,0,0
1.1** **THE GROUP—MISSION AND BRANDS,0,0,0,0,0
4.5.1 SALE OF GOODS,0,0,0,0,0
4.5.2 DIVIDENDS,0,0,0,0,0
4.5.3 RENTAL REVENUES,0,0,0,0,0
4.6.2 DEFERRED TAX ASSETS AND LIABILITIES,0,0,0,0,0
4.6.3 INDIRECT TAXES,0,0,0,0,0
6.3.1** **IMPAIRMENT OF NON-FINANCIAL ASSETS,0,0,0,0,0
6.3.2** **ALLOCATION FOR IMPAIRMENT OF TRADE RECEIVABLES AND CONTRACTUAL ASSETS,0,0,0,0,0
6.3.3** **FINANCIAL RISK MANAGEMENT OBJECTIVES AND CRITERIA,0,0,0,0,0
6.3.4** **INTEREST RATE RISK,0,0,0,0,0
6.3.5** **EXCHANGE RATE RISK,0,0,0,0,0
33** **SERVICE COSTS,0,0,0,0,0
"36** **AMORTIZATION, DEPRECIATION AND IMPAIRMENT",0,0,0,0,0
40** **EVENTS AFTER THE REPORTING PERIOD,0,0,0,0,0
1.1 COMPANY THAT EXERCISES MANAGEMENT AND COORDINATION ACTIVITIES,0,0,0,0,0
4.2** **BUSINESS COMBINATIONS AND GOODWILL,0,0,0,0,0
4.3** **CURRENT/NON-CURRENT CLASSIFICATION,0,0,0,0,0
4.4** **TRANSLATION OF FINANCIAL STATEMENTS EXPRESSED IN A DIFFERENT CURRENCY FROM THE FUNCTIONAL CURRENCY,0,0,0,0,0
4.5** **FAIR VALUE MEASUREMENT,0,0,0,0,0
4.6** **REVENUE RECOGNITION,0,0,0,0,0
4.6.1 SALE OF GOODS,0,0,0,0,0
4.6.2 DIVIDENDS,0,0,0,0,0
4.6.3 RENTAL REVENUES,0,0,0,0,0
4.7.2 DEFERRED TAX ASSETS AND LIABILITIES,0,0,0,0,0
4.7.3** **INDIRECT TAXES,0,0,0,0,0
4.8** **NON CURRENT ASSETS HELD FOR DISPOSAL,0,0,0,0,0
"4.9** **PROPERTY, PLANT AND EQUIPMENT",0,0,0,0,0
4.10** **LEASING,0,0,0,0,0
4.11** **OTHER INTANGIBLE ASSETS,0,0,0,0,0
4.11.1 RESEARCH AND DEVELOPMENT COSTS,0,0,0,0,0
4.11.2 LICENCES AND SIMILAR RIGHTS,0,0,0,0,0
4.11.3 TRADEMARK,0,0,0,0,0
4.12** **FINANCIAL ASSETS,0,0,0,0,0
4.13** **FINANCIAL LIABILITIES,0,0,0,0,0
4.14** **INVENTORIES,0,0,0,0,0
4.15** **IMPAIRMENT OF NON-FINANCIAL ASSETS,0,0,0,0,0
4.15.1 GOODWILL,0,0,0,0,0
4.15.2 TRADEMARKS,0,0,0,0,0
4.16** **CASH AND CASH EQUIVALENTS AND SHORT-TERM DEPOSITS,0,0,0,0,0
4.17** **TREASURY SHARES,0,0,0,0,0
4.18** **PROVISIONS FOR RISKS AND CHARGES,0,0,0,0,0
4.19** **PENSIONS AND OTHER POST-EMPLOYMENT BENEFITS,0,0,0,0,0
4.20** **SHARE-BASED PAYMENTS,0,0,0,0,0
AMENDMENTS TO IAS 16,0,0,0,0,0
AMENDMENTS TO IAS 37,0,0,0,0,0
AMENDMENTS TO IAS 1 PRESENTATION OF THE FINANCIAL STATEMENTS: CLASSIFICATION OF LIABILITIES AS CURRENT OR NON-CURRENT AND DEFERRAL OF THE DATE OF EFFECTIVENESS OF THE CLASSIFICATION OF LIABILITIES AS CURRENT AND NON-CURRENT,0,0,0,0,0
"AMENDMENTS TO IAS 8, ACCOUNTING STANDARDS, CHANGES IN ACCOUNTING ESTIMATES AND ERRORS: DEFINITION OF ACCOUNTING ESTIMATE.",0,0,0,0,0
AMENDMENTS TO IAS 12 INCOME TAXES: DEFERRED TAXES RELATING TO ASSETS AND LIABILITIES ARISING FROM A SINGLE TRANSACTION,0,0,0,0,0
6.1 SIGNIFICANT JUDGMENT IN DETERMINING THE DURATION OF THE LEASING OF CONTRACTS THAT CONTAIN AN EXTENSION OPTION,0,0,0,0,0
6.3.2 ALLOCATION FOR IMPAIRMENT OF TRADE RECEIVABLES AND CONTRACTUAL ASSETS,0,0,0,0,0
6.3.6 CREDIT RISK,0,0,0,0,0
6.3.7 FINANCIAL INSTRUMENTS AND BANK DEPOSITS,0,0,0,0,0
6.3.8 LIQUIDITY RISK,0,0,0,0,0
12.1** **IMPAIRMENT TEST ON GOODWILL AND ON INTANGIBLE ASSETS WITH INDEFINITE USEFUL LIFE,0,0,0,0,0
25** **DEFINED BENEFIT PLANS,0,0,0,0,0
30** **REVENUES FROM CONTRACTS WITH CUSTOMERS,0,0,0,0,0
32** **PURCHASES OF RAW MATERIALS AND CHANGES IN INVENTORIES,0,0,0,0,0
33** **PERSONNEL COSTS,0,0,0,0,0
35** **PROVISIONS,0,0,0,0,0
39** **TAXATION,0,0,0,0,0
40** **EARNINGS PER SHARE (EPS),0,0,0,0,0
41** **EVENTS AFTER THE REPORTING PERIOD,0,0,0,0,0
1.1** **COMPANY THAT EXERCISES MANAGEMENT AND COORDINATION ACTIVITIES,0,0,0,0,0
3** **CONSOLIDATION PRINCIPLES,0,0,0,0,0
4.6.1** **SALE OF GOODS,0,0,0,0,0
4.6.2** **DIVIDENDS,0,0,0,0,0
4.6.3** **RENTAL REVENUES,0,0,0,0,0
4.7.2** **DEFERRED TAX ASSETS AND LIABILITIES,0,0,0,0,0
4.8** **ASSETS HELD FOR DISPOSAL,0,0,0,0,0
4.9.1** **LEASING,0,0,0,0,0
"4.10.2 TRADEMARKS, LICENCES AND SIMILAR RIGHTS",0,0,0,0,0
6** **DISCRETIONARY VALUATIONS AND SIGNIFICANT ACCOUNTING ESTIMATES,0,0,0,0,0
6.1** **DISCRETIONARY VALUATIONS,0,0,0,0,0
6.2** **USE OF ESTIMATES,0,0,0,0,0
6.2.1** **IMPAIRMENT OF NON-FINANCIAL ASSETS,0,0,0,0,0
6.2.2** **ALLOCATION FOR IMPAIRMENT OF TRADE RECEIVABLES AND CONTRACTUAL ASSETS,0,0,0,0,0
6.3** **FINANCIAL RISK MANAGEMENT OBJECTIVES AND CRITERIA,0,0,0,0,0
6.3.1** **INTEREST RATE RISK,0,0,0,0,0
6.3.2** **EXCHANGE RATE RISK,0,0,0,0,0
6.3.3** **CREDIT RISK,0,0,0,0,0
6.3.4** **FINANCIAL INSTRUMENTS AND BANK DEPOSITS,0,0,0,0,0
6.3.5** **LIQUIDITY RISK,0,0,0,0,0
6.5** **FAIR VALUE MEASUREMENT,0,0,0,0,0
6.6** **SEGMENT INFORMATION,0,0,0,0,0
8** **OTHER INTANGIBLE ASSETS,0,0,0,0,0
"9** **PROPERTY, PLANT AND EQUIPMENT",0,0,0,0,0
10** **RIGHT OF USE AND FINANCIAL LEASE LIABILITIES,0,0,0,0,0
11** **SHAREHOLDING IN PARENT COMPANY,0,0,0,0,0
12** **DEFERRED TAX ASSETS,0,0,0,0,0
14** **INVENTORIES,0,0,0,0,0
15** **TRADE RECEIVABLES,0,0,0,0,0
PROVISION FOR IMPAIRMENT OF RECEIVABLES,0,0,0,0,0
16.2 OTHER CURRENT ASSETS,0,0,0,0,0
17** **CASH AND CASH EQUIVALENTS AND DEPOSITS,0,0,0,0,0
18** **ASSETS HELD FOR DISPOSAL,0,0,0,0,0
19** **SHAREHOLDERS’ EQUITY,0,0,0,0,0
21** **PROVISIONS FOR RISKS AND OTHER CHARGES,0,0,0,0,0
21.2** **OTHER PROVISIONS FOR RISKS AND CHARGES,0,0,0,0,0
22** **CURRENT AND NON-CURRENT FINANCIAL LIABILITIES,0,0,0,0,0
23** **DEFERRED TAX LIABILITIES,0,0,0,0,0
25** **TRADE PAYABLES,0,0,0,0,0
27** **REVENUES,0,0,0,0,0
27.1** **DISAGGREGATED REVENUES,0,0,0,0,0
28** **OTHER REVENUES AND INCOME,0,0,0,0,0
29** **PURCHASES OF RAW MATERIALS AND VARIATION IN INVENTORIES,0,0,0,0,0
30** **PERSONNEL COSTS,0,0,0,0,0
31** **SERVICE COSTS,0,0,0,0,0
"34** **AMORTIZATION, DEPRECIATION AND IMPAIRMENT",0,0,0,0,0
36** **FINANCIAL CHARGES,0,0,0,0,0
37** **INCOME TAXES,0,0,0,0,0
38** **EARNINGS PER SHARE (EPS),0,0,0,0,0
39** **RELATED PARTY DISCOUSURE,0,0,0,0,0
PROSPECTUS SUPPLEMENT,0,0,0,0,0
DESCRIPTION OF WARRANTS,0,0,0,0,0
STATE”) OF THE EUROPEAN ECONOMIC AREA (“EEA”) AND NOT RETAIL INVESTORS (AS,0,0,0,0,0
REGULATION”) OR ANY IMPLEMENTING LEGISLATION OR RULES RELATING THERETO.,0,0,0,0,0
TRANSACTION” PURSUANT TO RULE 904 OF REGULATION S UNDER THE,0,0,0,0,0
"NEW IFRS AND IFRIC ACCOUNTING STANDARDS, AMENDMENTS AND INTERPRETATIONS ALREADY APPROVED BY THE EUROPEAN UNION",0,0,0,0,0
"IFRS AND IFRIC ACCOUNTING STANDARDS, AMENDMENTS AND INTERPRETATIONS NOT YET APPROVED BY THE EUROPEAN UNION",0,0,0,0,0
LIST OF EQUITY-ACCOUNTED INVESTMENTS,0,0,0,0,0
LIST OF INVESTMENTS IN OTHER COMPANIES,0,0,0,0,0
"IFRS AND IFRIC ACCOUNTING STANDARDS, AMENDMENTS AND INTERPRETATIONS APPROVED BY THE EUROPEAN UNION BUT NOT YET OBLIGATORILY APPLICABLE AND NOT SUBJECT TO EARLY ADOPTION BY THE GROUP:",0,0,0,0,0
"AS AT THE DATE OF THIS ANNUAL FINANCIAL REPORT, THE COMPETENT BODIES OF THE EUROPEAN UNION HAD NOT YET COMPLETED THE APPROVAL PROCESS REQUIRED FOR THE ADOPTION OF THE FOLLOWING ACCOUNTING STANDARDS AND AMENDMENTS:",0,0,0,0,0
CONSOLIDATION OF FOREIGN COMPANIES,0,0,0,0,0
EQUITY INVESTMENTS,0,0,0,0,0
ASSOCIATES,0,0,0,0,0
JOINT VENTURES,0,0,0,0,0
TANGIBLE FIXED ASSETS,0,0,0,0,0
RIGHTS OF USE,0,0,0,0,0
ASSETS/LIABILITIES HELD FOR SALE,0,0,0,0,0
INTANGIBLE FIXED ASSETS,0,0,0,0,0
IMPAIRMENT,0,0,0,0,0
DERIVATIVE INSTRUMENTS,0,0,0,0,0
AVAILABLE-FOR-SALE FINANCIAL ASSETS,0,0,0,0,0
TRADE AND OTHER RECEIVABLES,0,0,0,0,0
PAYABLES TO BANKS AND OTHER LENDERS,0,0,0,0,0
TRADE AND OTHER PAYABLES,0,0,0,0,0
FOREIGN EXCHANGE DIFFERENCES,0,0,0,0,0
FINANCIAL INSTRUMENTS AND RISK MANAGEMENT,0,0,0,0,0
ESTIMATES AND VALUATIONS,0,0,0,0,0
FAIR VALUE OF DERIVATIVE CONTRACTS AND FINANCIAL INSTRUMENTS,0,0,0,0,0
IMPAIRMENT TESTS,0,0,0,0,0
2.** **OTHER REVENUES,0,0,0,0,0
3.** **CHANGE IN INVENTORIES OF FINISHED GOODS,0,0,0,0,0
7.** **AMORTIZATION AND DEPRECIATION,0,0,0,0,0
8.** **WRITE-DOWNS,0,0,0,0,0
10. INCOME (LOSSES) FROM EQUITY INVESTMENTS,0,0,0,0,0
12. TANGIBLE FIXED ASSETS,0,0,0,0,0
13. RIGHTS OF USE,0,0,0,0,0
14. GOODWILL,0,0,0,0,0
15. INTANGIBLE FIXED ASSETS,0,0,0,0,0
17. DEFERRED TAX ASSETS,0,0,0,0,0
19. OTHER RECEIVABLES AND OTHER RECEIVABLES FROM ASSOCIATES AND JOINT VENTURES,0,0,0,0,0
22. SHAREHOLDERS’ EQUITY,0,0,0,0,0
23. DERIVATIVE INSTRUMENTS,0,0,0,0,0
24. OTHER PAYABLES AND OTHER PAYABLES TO ASSOCIATES AND JOINT VENTURES,0,0,0,0,0
25. DEFERRED TAXES,0,0,0,0,0
27. NON-CURRENT AND CURRENT PROVISIONS FOR RISKS AND CHARGES,0,0,0,0,0
28. TRADE PAYABLES,0,0,0,0,0
29. CURRENT TAXES,0,0,0,0,0
31. CONTINGENT LIABILITIES AND COMMITMENTS AND OTHER GUARANTEES GIVEN TO THIRD PARTIES,0,0,0,0,0
VALUATION METHODS,0,0,0,0,0
SUBSEQUENT EVENTS,0,0,0,0,0
CERTIFICATION OF CONSOLIDATED FINANCIAL STATEMENTS,0,0,0,0,0
"EBITDA . . . . . . . . . . . . . . . . . . . . . . . . . . . . . . . . . . . . . . . . . . . . . . . . . . . . . . . . . . . . . . .** **1,735",0,0,0,0,0
"EBITDA . . . . . . . . . . . . . . . . . . . . . . . . . . . . . . . . . . . . . . . . . . . . . . . . . . . . . . . . . .** **1,499",0,0,0,0,0
"MARKETS, RANKING AND OTHER DATA",0,0,0,0,0
SPECIAL NOTE REGARDING NON-GAAP FINANCIAL MEASURES,0,0,0,0,0
"OFFERING MEMORANDUM , 2022",0,0,0,0,0
"THE PRECEDING DISCUSSION OF CERTAIN UNITED STATES FEDERAL INCOME TAX CONSIDERATIONS IS FOR GENERAL INFORMATION ONLY AND IS NOT TAX ADVICE. YOU SHOULD CONSULT YOUR OWN TAX ADVISOR REGARDING THE PARTICULAR U.S. FEDERAL, STATE, LOCAL AND FOREIGN TAX CONSEQUENCES OF ACQUIRING, OWNING AND DISPOSING",0,0,0,0,0
"OF OUR NOTES, INCLUDING THE CONSEQUENCES OF ANY PROPOSED CHANGE IN APPLICABLE LAWS.",0,0,0,0,0
CERTAIN INFORMATION WITH REGARD TO THE OFFERING RESPONSIBILITY STATEMENT,0,0,0,0,0
NOTICE TO PROSPECTIVE INVESTORS IN THE UNITED KINGDOM,0,0,0,0,0
TERMS AND CONDITIONS OF THE NOTES ANLEIHEBEDINGUNGEN,0,0,0,0,0
"§ 1 WÄHRUNG, STÜCKELUNG, FORM, BESTIMMTE DEFINITIONEN",0,0,0,0,0
TERMS AND CONDITIONS,0,0,0,0,0
"§ 1 CURRENCY, DENOMINATION, FORM CERTAIN DEFINITIONS",0,0,0,0,0
§ 2 STATUS,0,0,0,0,0
§ 3 NEGATIVVERPFLICHTUNG,0,0,0,0,0
§ 3 NEGATIVE PLEDGE,0,0,0,0,0
§ 4 VERZINSUNG,0,0,0,0,0
§ 4 INTEREST,0,0,0,0,0
§ 5 ZAHLUNGEN,0,0,0,0,0
§ 5 PAYMENTS,0,0,0,0,0
§ 6 RÜCKZAHLUNG,0,0,0,0,0
§ 6 REDEMPTION,0,0,0,0,0
§ 7 ZAHLSTELLE,0,0,0,0,0
§ 8 STEUERN,0,0,0,0,0
§ 7 PAYING AGENT,0,0,0,0,0
§ 8 TAX,0,0,0,0,0
"§ 9 VORLEGUNGSFRIST, VERJÄHRUNG",0,0,0,0,0
§ 10 KÜNDIGUNGSGRÜNDE,0,0,0,0,0
"§ 9 PRESENTATION PERIOD, PRESCRIPTION",0,0,0,0,0
§ 10 EVENTS OF DEFAULT,0,0,0,0,0
§ 11 VERPFLICHTUNGSERKLÄRUNGEN,0,0,0,0,0
§ 11 COVENANTS,0,0,0,0,0
§ 12 ERSETZUNG,0,0,0,0,0
§ 12 SUBSTITUTION,0,0,0,0,0
"§ 13 BEGEBUNG WEITERER SCHULDVERSCHREIBUNGEN, ANKAUF UND ENTWERTUNG",0,0,0,0,0
"§ 13 FURTHER ISSUES, PURCHASES AND CANCELLATION",0,0,0,0,0
"§ 14 ÄNDERUNG DER ANLEIHEBEDINDUNGEN DURCH BESCHLÜSSE DER GLÄUBIGER, GEMEINSAMER VERTRETER",0,0,0,0,0
"§ 14 AMENDMENTS OF THE TERMS AND CONDITIONS BY RESOLUTIONS OF HOLDERS, JOINT REPRESENTATIVE",0,0,0,0,0
§ 15 MITTEILUNGEN,0,0,0,0,0
§ 15 NOTICES,0,0,0,0,0
§ 16 DEFINITIONEN,0,0,0,0,0
§ 16 DEFINITIONS,0,0,0,0,0
"§ 17 ANWENDBARES RECHT, ERFÜLLUNGSORT UND GERICHTSSTAND, GERICHTLICHE GELTENDMACHUNG",0,0,0,0,0
"§ 17 GOVERNING LAW, PLACE OF PERFORMANCE AND PLACE OF JURISDICTION; ENFORCEMENT",0,0,0,0,0
§ 18 SPRACHE,0,0,0,0,0
§ 18 LANGUAGE,0,0,0,0,0
SELECTED CONSOLIDATED FINANCIAL INFORMATION OF THE COMPANY,0,0,0,0,0
MANAGEMENT’S DISCUSSION AND ANALYSIS OF NET ASSETS; FINANCIAL CONDITION AND RESULTS OF OPERATIONS,0,0,0,0,0
PRO FORMA CONSOLIDATED FINANCIAL INFORMATION OF ADLER GROUP S.A.,0,0,0,0,0
INDEPENDENT AUDITOR’S ASSURANCE REPORT ON THE COMPILATION OF PRO FORMA FINANCIAL INFORMATION INCLUDED IN A OFFERING MEMORANDUM,0,0,0,0,0
SHAREHOLDER STRUCTURE,0,0,0,0,0
CERTAIN RELATIONSHIPS AND RELATED-PARTY TRANSACTIONS,0,0,0,0,0
SUMMARY OF THE VALUATION CONCLUSIONS,0,0,0,0,0
4** **VALUATION CONCLUSIONS,0,0,0,0,0
ADDRESSES,0,0,0,0,0
MANAGER”) (OR PERSONS ACTING ON BEHALF OF THE STABILIZING MANAGER) MAY,0,0,0,0,0
CONTINUING OPERATIONS,0,0,0,0,0
RESTRICTION TERMINATION DATE”) WHICH IS 40 DAYS AFTER THE LATER OF,0,0,0,0,0
DEFINED BENEFIT PLAN,0,0,0,0,0
SENSITIVITY ANALYSIS,0,0,0,0,0
SENSITIVITY TO A CHANGE IN INTEREST RATES,0,0,0,0,0
EXPOSURE TO FOREIGN CURRENCY RISK,0,0,0,0,0
SENSITIVITY OF NET EXPOSURE AFTER FOREIGN CURRENCY HEDGING,0,0,0,0,0
SENSITIVITY TO TRANSLATION RISK,0,0,0,0,0
BREAKDOWN OF CASH AND CASH EQUIVALENTS BY CURRENCY,0,0,0,0,0
EQUITY RISK,0,0,0,0,0
COUNTERPARTY RISK RELATED TO TRADE RECEIVABLES,0,0,0,0,0
EXPOSURE TO LIQUIDITY RISK,0,0,0,0,0
SUMMARISED FINANCIAL INFORMATION ON THE MAIN SUBSIDIARIES WITH MATERIAL NON-CONTROLLING INTERESTS,0,0,0,0,0
EQUIPMENT LEASES WHERE THE GROUP IS LESSEE,0,0,0,0,0
OPERATING LEASES WHERE THE GROUP IS LESSOR,0,0,0,0,0
"CASINO,** **GUICHARD-PERRACHON DEBT COVENANTS",0,0,0,0,0
FINANCING OF SUBSIDIARIES SUBJECT TO COVENANTS,0,0,0,0,0
SUMMARISED FINANCIAL INFORMATION ON THE MAIN SUBSIDIARIES WITH SIGNIFICANT NON-CONTROLLING INTERESTS,0,0,0,0,0
DELOITTE &** **ASSOCIES,0,0,0,0,0
PRESENTATION OF CERTAIN FINANCIAL MEASURES,0,0,0,0,0
WHERE YOU CAN FIND MORE INFORMATION AND INCORPORATION BY REFERENCE,0,0,0,0,0
